//MAP CONVERTED BY dmm2tgm.py THIS HEADER COMMENT PREVENTS RECONVERSION, DO NOT REMOVE
"b" = (
/obj/machinery/suspension_gen{
	dir = 4
	},
/turf/unsimulated/floor/asteroid/air,
/area/exposed_ruin)
"d" = (
/obj/item/trash/bowl,
/obj/item/trash/soda_cans{
	pixel_x = 10;
	pixel_y = 9
	},
/turf/template_noop,
/area/exposed_ruin)
"e" = (
/obj/effect/decal/cleanable/dirt,
/obj/item/device/measuring_tape,
/turf/unsimulated/floor/asteroid/air,
/area/exposed_ruin)
"h" = (
/obj/structure/fence/door,
/obj/effect/decal/cleanable/dirt,
/obj/item/tape/engineering{
	icon_state = "engineering_door"
	},
/turf/template_noop,
/area/exposed_ruin)
"j" = (
/turf/unsimulated/floor/asteroid/air,
/area/exposed_ruin)
"k" = (
/obj/effect/decal/cleanable/dirt,
/turf/unsimulated/floor/asteroid/air,
/area/exposed_ruin)
"l" = (
/obj/structure/table,
/obj/effect/decal/cleanable/dirt,
/obj/item/weapon/pickaxe/plasmacutter,
/turf/template_noop,
/area/exposed_ruin)
"o" = (
/obj/structure/closet/crate,
/obj/item/weapon/pickaxe,
/obj/item/weapon/pickaxe/hand,
/obj/item/clothing/gloves/latex,
/obj/item/clothing/glasses/scanner/science,
/turf/template_noop,
/area/exposed_ruin)
"q" = (
/obj/structure/table,
/obj/effect/decal/cleanable/dirt,
/obj/item/weapon/storage/box/excavation,
/obj/item/weapon/pickaxe/excavationdrill,
/turf/template_noop,
/area/exposed_ruin)
"r" = (
/obj/structure/bed/chair/folding{
	dir = 8
	},
/turf/template_noop,
/area/exposed_ruin)
"u" = (
/obj/machinery/floodlight,
/turf/template_noop,
/area/exposed_ruin)
"v" = (
/obj/effect/decal/cleanable/dirt,
/turf/unsimulated/floor/asteroid/air{
	color = "#a37552"
	},
/area/exposed_ruin)
"w" = (
/obj/effect/decal/cleanable/dirt,
/obj/item/stack/sheet/bone{
	pixel_x = -7;
	pixel_y = 7
	},
/turf/unsimulated/floor/asteroid/air{
	color = "#a37552"
	},
/area/exposed_ruin)
"y" = (
/obj/machinery/floodlight,
/turf/unsimulated/floor/asteroid/air,
/area/exposed_ruin)
"A" = (
/obj/effect/decal/cleanable/dirt,
/obj/item/weapon/fossil/bone,
/turf/unsimulated/floor/asteroid/air{
	color = "#a37552"
	},
/area/exposed_ruin)
"B" = (
/obj/structure/table,
/obj/item/device/flashlight/lantern,
/turf/template_noop,
/area/exposed_ruin)
"E" = (
/obj/structure/bed/chair/folding,
/turf/template_noop,
/area/exposed_ruin)
"F" = (
/obj/effect/decal/cleanable/dirt,
/obj/item/trash/liquidfood,
/turf/template_noop,
/area/exposed_ruin)
"G" = (
/obj/structure/bed/chair/folding{
	dir = 4
	},
/turf/template_noop,
/area/exposed_ruin)
"H" = (
/obj/effect/decal/cleanable/dirt,
/turf/template_noop,
/area/exposed_ruin)
"I" = (
/obj/structure/largecrate,
/turf/template_noop,
/area/exposed_ruin)
"K" = (
/obj/effect/decal/cleanable/dirt,
/obj/item/stack/sheet/bone,
/obj/item/stack/sheet/bone{
	pixel_x = 5;
	pixel_y = -3
	},
/turf/unsimulated/floor/asteroid/air{
	color = "#a37552"
	},
/area/exposed_ruin)
"L" = (
/obj/structure/fence,
/turf/template_noop,
/area/exposed_ruin)
"M" = (
/obj/structure/bed/chair/folding{
	dir = 4
	},
/obj/effect/decal/cleanable/dirt,
/turf/template_noop,
/area/exposed_ruin)
"P" = (
/obj/item/weapon/pickaxe/shovel,
/turf/unsimulated/floor/asteroid/air,
/area/exposed_ruin)
"T" = (
/obj/structure/bed/chair/folding{
	dir = 1
	},
/turf/template_noop,
/area/exposed_ruin)
"V" = (
/obj/effect/decal/cleanable/dirt,
/obj/effect/decal/remains/human,
/turf/unsimulated/floor/asteroid/air{
	color = "#a37552"
	},
/area/exposed_ruin)
"W" = (
/obj/structure/anomaly_container,
/obj/machinery/artifact,
/turf/unsimulated/floor/asteroid/air,
/area/exposed_ruin)
"X" = (
/turf/template_noop,
/area/exposed_ruin)
"Y" = (
/obj/effect/decal/cleanable/campfire,
/obj/effect/decal/cleanable/dirt,
/turf/template_noop,
/area/exposed_ruin)
"Z" = (
/obj/structure/table,
/obj/item/device/depth_scanner,
/obj/item/weapon/book/manual/excavation{
	pixel_x = 1;
	pixel_y = 8
	},
/turf/template_noop,
/area/exposed_ruin)

(1,1,1) = {"
L
L
L
L
L
L
L
X
X
X
X
X
X
X
"}
(2,1,1) = {"
L
k
j
W
b
b
L
X
G
G
X
X
X
X
"}
(3,1,1) = {"
L
k
j
k
k
j
L
E
B
l
X
X
X
X
"}
(4,1,1) = {"
L
k
k
A
V
k
L
E
Z
q
X
M
d
X
"}
(5,1,1) = {"
L
y
k
K
v
k
h
H
X
H
X
Y
T
X
"}
(6,1,1) = {"
L
k
e
V
A
j
L
o
H
X
X
r
F
X
"}
(7,1,1) = {"
L
j
k
v
w
k
L
o
X
X
X
X
X
X
"}
(8,1,1) = {"
L
j
j
k
k
P
L
I
X
X
X
X
X
X
"}
(9,1,1) = {"
L
L
L
L
L
L
L
u
X
X
X
X
X
X
"}
