//MAP CONVERTED BY dmm2tgm.py THIS HEADER COMMENT PREVENTS RECONVERSION, DO NOT REMOVE
"ab" = (
/turf/template_noop,
/area/template_noop)
"ad" = (
/obj/structure/shuttle/diag_wall/smooth/black{
	dir = 4
	},
/turf/template_noop,
/area/template_noop)
"ae" = (
/obj/structure/boulder,
/obj/effect/decal/cleanable/dirt,
/turf/template_noop,
/area/template_noop)
"af" = (
/obj/structure/shuttle/diag_wall/smooth/black{
	dir = 8
	},
/turf/template_noop,
/area/template_noop)
"ag" = (
/obj/structure/shuttle/diag_wall/smooth/black{
	dir = 1
	},
/turf/template_noop,
/area/template_noop)
"ah" = (
/obj/effect/decal/cleanable/scattered_sand,
/turf/template_noop,
/area/template_noop)
"ai" = (
/obj/structure/door_assembly/door_assembly_ext,
/turf/simulated/floor/plating,
/area/ruin)
"aj" = (
/obj/structure/shuttle/diag_wall/smooth/black,
/turf/template_noop,
/area/template_noop)
"ak" = (
/obj/item/stack/rods,
/obj/effect/decal/cleanable/dirt,
/turf/template_noop,
/area/template_noop)
"aq" = (
/obj/structure/grille/window_spawner/reinforced,
/turf/simulated/floor/plating,
/area/ruin)
"dg" = (
/obj/effect/decal/cleanable/dirt,
/turf/simulated/floor/shuttle{
	icon_state = "floor3"
	},
/area/ruin)
"ep" = (
/obj/structure/bed/chair,
/turf/simulated/floor/shuttle{
	icon_state = "floor3"
	},
/area/ruin)
"et" = (
/obj/structure/bed/chair{
	dir = 1
	},
/turf/simulated/floor/shuttle{
	icon_state = "floor3"
	},
/area/ruin)
"fb" = (
/obj/effect/decal/cleanable/dirt,
/obj/effect/decal/cleanable/blood/drip{
	basecolor = "#2299FC"
	},
/obj/effect/decal/cleanable/blood/drip{
	basecolor = "#2299FC";
	pixel_x = 6;
	pixel_y = 11
	},
/turf/simulated/floor/shuttle{
	icon_state = "floor3"
	},
/area/ruin)
"fO" = (
/obj/item/weapon/rack_parts,
/obj/abstract/map/spawner/assistant/materials,
/turf/simulated/floor/shuttle{
	icon_state = "floor3"
	},
/area/ruin)
"fQ" = (
/turf/simulated/wall/shuttle/unsmoothed{
	dir = 1;
	icon_state = "wall3"
	},
/area/ruin)
"gb" = (
/obj/effect/decal/cleanable/scattered_sand,
/obj/item/weapon/shard,
/turf/template_noop,
/area/template_noop)
"jk" = (
/obj/structure/window/reinforced{
	dir = 1
	},
/obj/structure/grille/broken,
/obj/effect/decal/cleanable/dirt,
/obj/item/weapon/shard,
/turf/simulated/floor/plating,
/area/ruin)
"kr" = (
/obj/structure/grille,
/obj/structure/window/reinforced{
	one_way = 1
	},
/obj/structure/window/reinforced{
	dir = 8
	},
/obj/item/weapon/shard{
	icon_state = "small"
	},
/obj/item/weapon/shard{
	icon_state = "small";
	pixel_x = 5;
	pixel_y = -5
	},
/turf/simulated/floor/plating,
/area/ruin)
"kv" = (
/obj/effect/decal/cleanable/soot,
/obj/effect/decal/cleanable/blood/gibs/robot/down,
/obj/effect/decal/cleanable/blood/oil/streak,
/turf/template_noop,
/area/template_noop)
"md" = (
/obj/structure/bed/chair,
/obj/effect/decal/cleanable/blood/splatter{
	basecolor = "#2299FC"
	},
/obj/effect/landmark/corpse/vox/crossbow/space,
/turf/simulated/floor/shuttle{
	icon_state = "floor2"
	},
/area/ruin)
"mr" = (
/obj/structure/shuttle/engine/heater,
/obj/effect/decal/cleanable/soot,
/turf/template_noop,
/area/template_noop)
"mw" = (
/obj/effect/decal/cleanable/soot,
/obj/effect/decal/cleanable/blood/oil/streak,
/turf/template_noop,
/area/template_noop)
"ng" = (
/obj/effect/decal/cleanable/dirt,
/obj/item/stack/sheet/metal{
	amount = 2
	},
/turf/template_noop,
/area/template_noop)
"oT" = (
/obj/effect/decal/cleanable/soot,
/obj/item/weapon/shard{
	icon_state = "medium"
	},
/turf/template_noop,
/area/template_noop)
"oY" = (
/obj/effect/decal/cleanable/soot,
/obj/item/weapon/shard{
	icon_state = "small";
	pixel_x = 5;
	pixel_y = -5
	},
/turf/template_noop,
/area/template_noop)
"px" = (
/obj/machinery/light/broken{
	dir = 4
	},
/turf/simulated/floor/shuttle{
	icon_state = "floor3"
	},
/area/ruin)
"qx" = (
/obj/structure/computerframe{
	anchored = 1
	},
/obj/effect/decal/cleanable/scattered_sand,
/turf/simulated/floor/plating,
/area/ruin)
"qV" = (
/obj/effect/decal/cleanable/soot,
/obj/item/stack/rods,
/turf/simulated/floor/plating,
/area/ruin)
"tD" = (
/obj/effect/decal/cleanable/dirt,
/obj/item/weapon/broken_bottle,
/turf/simulated/floor/shuttle{
	icon_state = "floor3"
	},
/area/ruin)
"vG" = (
/obj/structure/shuttle/engine/propulsion{
	dir = 1
	},
/obj/effect/decal/cleanable/dirt,
/turf/template_noop,
/area/template_noop)
"vT" = (
/obj/item/weapon/rack_parts,
/turf/simulated/floor/shuttle{
	icon_state = "floor3"
	},
/area/ruin)
"wB" = (
/obj/structure/table/reinforced,
/obj/structure/window/reinforced{
	dir = 1
	},
/obj/abstract/map/spawner/maint,
/turf/simulated/floor/shuttle{
	icon_state = "floor3"
	},
/area/ruin)
"xL" = (
/obj/structure/window/reinforced{
	dir = 1
	},
/obj/effect/decal/cleanable/scattered_sand,
/obj/item/stack/rods,
/turf/simulated/floor/shuttle{
	icon_state = "floor2"
	},
/area/ruin)
"xQ" = (
/obj/item/weapon/rack_parts,
/turf/template_noop,
/area/template_noop)
"yG" = (
/obj/structure/grille/broken,
/obj/effect/decal/cleanable/dirt,
/turf/simulated/floor/plating,
/area/ruin)
"yN" = (
/obj/item/weapon/shard{
	icon_state = "medium"
	},
/turf/template_noop,
/area/template_noop)
"zj" = (
/obj/effect/decal/cleanable/soot,
/turf/simulated/floor/plating,
/area/ruin)
"zy" = (
/obj/structure/grille,
/obj/item/weapon/shard,
/obj/structure/window/reinforced{
	one_way = 1
	},
/obj/structure/window/reinforced{
	dir = 8
	},
/turf/simulated/floor/plating,
/area/ruin)
"zG" = (
/obj/item/weapon/shard{
	icon_state = "small";
	pixel_x = 5;
	pixel_y = -5
	},
/obj/structure/grille/window_spawner/reinforced,
/turf/simulated/floor/plating,
/area/ruin)
"Ar" = (
/obj/item/stack/sheet/metal,
/turf/template_noop,
/area/template_noop)
"BM" = (
/obj/structure/shuttle/engine/heater{
	dir = 1
	},
/obj/structure/window/reinforced,
/turf/simulated/floor/plating,
/area/ruin)
"Cp" = (
/obj/structure/grille,
/obj/structure/window/reinforced{
	dir = 8
	},
/obj/item/weapon/shard,
/turf/simulated/floor/plating,
/area/ruin)
"CW" = (
/obj/effect/decal/cleanable/dirt,
/obj/effect/decal/cleanable/blood/drip{
	basecolor = "#2299FC";
	pixel_x = 6;
	pixel_y = 11
	},
/obj/effect/decal/cleanable/blood/drip{
	basecolor = "#2299FC"
	},
/obj/effect/decal/cleanable/blood/splatter{
	basecolor = "#2299FC"
	},
/obj/abstract/loot_spawner/exotic,
/turf/simulated/floor/shuttle{
	icon_state = "floor3"
	},
/area/ruin)
"Dh" = (
/obj/structure/window/reinforced{
	dir = 8
	},
/obj/structure/window/reinforced{
	dir = 1
	},
/obj/structure/grille/broken,
/obj/effect/decal/cleanable/dirt,
/obj/item/weapon/shard{
	icon_state = "medium"
	},
/turf/simulated/floor/plating,
/area/ruin)
"DA" = (
/obj/effect/decal/cleanable/dirt,
/obj/item/stack/rods,
/turf/template_noop,
/area/template_noop)
"DD" = (
/obj/structure/girder,
/turf/simulated/floor/plating,
/area/ruin)
"DO" = (
/obj/structure/bed/chair,
/obj/machinery/light/broken{
	dir = 1
	},
/turf/simulated/floor/shuttle{
	icon_state = "floor3"
	},
/area/ruin)
"FS" = (
/obj/structure/flora/pottedplant/claypot,
/turf/simulated/floor/shuttle{
	icon_state = "floor3"
	},
/area/ruin)
"FX" = (
/obj/effect/decal/cleanable/scattered_sand,
/obj/effect/decal/cleanable/soot,
/obj/effect/decal/cleanable/blood/gibs/robot/down,
/obj/item/weapon/shard{
	icon_state = "small";
	pixel_x = 5;
	pixel_y = -5
	},
/obj/effect/decal/cleanable/blood/oil/streak,
/turf/template_noop,
/area/template_noop)
"Gd" = (
/obj/structure/flora/rock/pile,
/turf/template_noop,
/area/template_noop)
"Hf" = (
/obj/effect/decal/cleanable/soot,
/obj/effect/decal/cleanable/dirt,
/turf/template_noop,
/area/template_noop)
"HZ" = (
/obj/structure/flora/rock,
/turf/template_noop,
/area/template_noop)
"IT" = (
/obj/item/weapon/rack_parts,
/obj/abstract/map/spawner/assistant/tools,
/turf/simulated/floor/shuttle{
	icon_state = "floor3"
	},
/area/ruin)
"KY" = (
/obj/structure/grille/window_spawner/reinforced,
/turf/simulated/floor/plating/vox,
/area/ruin)
"LV" = (
/obj/effect/decal/cleanable/soot,
/turf/simulated/floor/shuttle{
	icon_state = "floor3"
	},
/area/ruin)
"Rl" = (
/obj/structure/shuttle/engine/propulsion{
	dir = 4
	},
/obj/effect/decal/cleanable/soot,
/turf/template_noop,
/area/template_noop)
"Rs" = (
/obj/structure/grille,
/obj/structure/window/reinforced{
	dir = 4
	},
/turf/simulated/floor/plating,
/area/ruin)
"RR" = (
/obj/effect/decal/cleanable/dirt,
/turf/template_noop,
/area/template_noop)
"RW" = (
/obj/structure/table,
/obj/effect/decal/cleanable/scattered_sand,
/obj/abstract/map/spawner/maint,
/turf/simulated/floor/shuttle{
	icon_state = "floor2"
	},
/area/ruin)
"Sc" = (
/obj/structure/table,
/obj/item/weapon/shard,
/obj/item/weapon/reagent_containers/food/drinks/bottle/whiskey,
/obj/abstract/loot_spawner/food_or_drink,
/turf/simulated/floor/shuttle{
	icon_state = "floor2"
	},
/area/ruin)
"SD" = (
/obj/effect/decal/cleanable/dirt,
/turf/simulated/floor/plating/damaged/broken,
/area/ruin)
"SR" = (
/obj/item/weapon/shard{
	icon_state = "small";
	pixel_x = 5;
	pixel_y = -5
	},
/turf/simulated/floor/plating,
/area/ruin)
"TS" = (
/obj/structure/table/reinforced,
/obj/structure/window/reinforced{
	dir = 1
	},
/obj/abstract/loot_spawner/combat,
/turf/simulated/floor/shuttle{
	icon_state = "floor3"
	},
/area/ruin)
"UB" = (
/obj/effect/decal/cleanable/scattered_sand,
/obj/effect/decal/cleanable/soot,
/obj/effect/decal/cleanable/dirt,
/obj/item/stack/rods,
/turf/template_noop,
/area/template_noop)
"UU" = (
/obj/effect/decal/cleanable/scattered_sand,
/obj/structure/grille/broken,
/obj/effect/decal/cleanable/dirt,
/obj/item/weapon/shard{
	icon_state = "small";
	pixel_x = 5;
	pixel_y = -5
	},
/obj/item/stack/rods,
/turf/simulated/floor/plating,
/area/ruin)
"VF" = (
/obj/item/weapon/table_parts/reinforced,
/turf/simulated/floor/shuttle{
	icon_state = "floor3"
	},
/area/ruin)
"VT" = (
/obj/effect/decal/cleanable/soot,
/obj/effect/decal/cleanable/dirt,
/obj/abstract/loot_spawner/structure,
/turf/template_noop,
/area/template_noop)
"Wf" = (
/obj/item/weapon/shard{
	icon_state = "small"
	},
/turf/template_noop,
/area/template_noop)
"WG" = (
/obj/effect/decal/cleanable/dirt,
/obj/effect/decal/cleanable/blood/splatter{
	basecolor = "#2299FC"
	},
/obj/effect/landmark/corpse/vox/crossbow/space,
/turf/simulated/floor/shuttle{
	icon_state = "floor3"
	},
/area/ruin)
"WZ" = (
/obj/effect/decal/cleanable/soot,
/obj/effect/decal/cleanable/dirt,
/obj/item/stack/rods,
/turf/template_noop,
/area/template_noop)
"Xz" = (
/obj/structure/bed/chair{
	dir = 1
	},
/obj/effect/decal/cleanable/dirt,
/turf/simulated/floor/shuttle{
	icon_state = "floor3"
	},
/area/ruin)
"Yj" = (
/obj/structure/boulder,
/turf/template_noop,
/area/template_noop)
"Yk" = (
/obj/effect/decal/cleanable/soot,
/turf/template_noop,
/area/template_noop)
"YD" = (
/obj/structure/door_assembly/door_assembly_ext{
	anchored = 1
	},
/turf/simulated/floor/shuttle{
	icon_state = "floor3"
	},
/area/ruin)
"Zb" = (
/obj/effect/decal/cleanable/soot,
/turf/simulated/floor/plating/damaged/broken,
/area/ruin)
"Zc" = (
/obj/structure/table/reinforced,
/obj/abstract/loot_spawner/module,
/turf/simulated/floor/shuttle{
	icon_state = "floor3"
	},
/area/ruin)
"Zl" = (
/obj/effect/decal/cleanable/soot,
/obj/item/weapon/broken_bottle,
/turf/simulated/floor/plating,
/area/ruin)
"Zv" = (
/obj/machinery/light/broken{
	dir = 8
	},
/obj/item/weapon/table_parts,
/obj/abstract/map/spawner/space/supply,
/turf/simulated/floor/shuttle{
	icon_state = "floor3"
	},
/area/ruin)
"ZQ" = (
/turf/simulated/floor/shuttle{
	icon_state = "floor3"
	},
/area/ruin)
"ZU" = (
/obj/structure/window/reinforced{
	dir = 1
	},
/obj/item/weapon/shard{
	icon_state = "small";
	pixel_x = 5;
	pixel_y = -5
	},
/turf/simulated/floor/shuttle{
	icon_state = "floor2"
	},
/area/ruin)

(1,1,1) = {"
ab
ab
ab
ab
ab
ab
ab
ab
ab
ab
ab
ab
ab
ab
ab
ab
ab
ab
ab
ab
ab
ab
ab
ab
ab
ab
ab
ab
"}
(2,1,1) = {"
ab
ab
ab
ab
ab
ab
ab
ab
ab
ab
ab
ab
Yj
RR
Gd
ab
ab
ab
ab
ab
ab
ab
ab
ab
ab
ab
ab
ab
"}
(3,1,1) = {"
ab
ab
ab
ab
ab
ab
ab
ab
ab
ab
ab
Yj
ab
RR
RR
xQ
Yj
ab
ab
ab
ab
ab
ab
ab
ab
ab
ab
ab
"}
(4,1,1) = {"
ab
ab
ab
ab
ab
ab
ab
mw
RR
ab
ab
ab
ab
ab
DA
RR
RR
RR
ab
Yj
ab
ab
ab
ab
ab
ab
ab
ab
"}
(5,1,1) = {"
ab
ab
ab
Yj
ab
UB
mr
oT
Hf
RR
ab
ab
RR
af
ai
YD
aj
Wf
yN
RR
ab
ab
ab
ab
ab
ab
ab
ab
"}
(6,1,1) = {"
ab
ab
ah
FX
Rl
Yk
VT
WZ
ab
ab
ab
ab
Yk
Zb
zj
LV
fQ
DD
yG
zy
aj
RR
Gd
ab
ab
ab
ab
ab
"}
(7,1,1) = {"
ab
ak
ab
Yk
gb
kv
Gd
ab
ab
RR
ab
Yk
oY
qV
Zb
SD
TS
Zv
dg
fO
fQ
aq
aj
ab
Yj
ab
ab
ab
"}
(8,1,1) = {"
ae
RR
RR
Ar
ab
ab
RR
RR
Gd
RR
ab
RR
RR
jk
Zl
zj
VF
WG
fb
CW
xL
Sc
Dh
RR
ab
ab
ab
ab
"}
(9,1,1) = {"
ab
ab
ab
ab
ab
RR
ab
RR
RR
HZ
ab
RR
RR
zG
ep
SR
Zc
Xz
tD
ZQ
md
qx
UU
RR
ab
ab
ab
ab
"}
(10,1,1) = {"
ab
Yj
ab
Gd
ab
Yj
ng
ab
ab
RR
RR
RR
ab
fQ
DO
ZQ
wB
ZQ
dg
et
ZU
RW
Rs
ab
ab
Yj
ab
ab
"}
(11,1,1) = {"
ab
ab
ab
ab
ab
ab
ab
Yj
ab
ab
ab
RR
vG
BM
FS
ZQ
ZQ
px
IT
vT
fQ
KY
ad
RR
Yj
ab
ab
ab
"}
(12,1,1) = {"
ab
ab
ab
ab
ab
ab
ab
ab
ab
ab
ab
ab
ab
ag
fQ
fQ
fQ
fQ
Cp
kr
ad
ab
ab
ab
ab
ab
ab
ab
"}
(13,1,1) = {"
ab
ab
ab
ab
ab
ab
ab
ab
ab
ab
ab
ab
Yj
ab
ab
ab
ab
ab
ab
ab
ab
ab
ab
ab
ab
ab
ab
ab
"}
(14,1,1) = {"
ab
ab
ab
ab
ab
ab
ab
ab
ab
ab
ab
ab
ab
ab
ab
ab
ab
ab
ab
ab
ab
ab
ab
ab
ab
ab
ab
ab
"}
