//MAP CONVERTED BY dmm2tgm.py THIS HEADER COMMENT PREVENTS RECONVERSION, DO NOT REMOVE
"a" = (
/obj/structure/shuttle/diag_wall/smooth{
	dir = 8
	},
/turf/template_noop,
/area/template_noop)
"b" = (
/obj/structure/shuttle/diag_wall/smooth{
	dir = 1
	},
/turf/template_noop,
/area/template_noop)
"c" = (
/obj/machinery/door/unpowered/shuttle,
/turf/simulated/floor/shuttle,
/area/ruin)
"e" = (
/obj/structure/flora/rock/pile,
/turf/template_noop,
/area/template_noop)
"f" = (
/obj/effect/decal/cleanable/soot,
/obj/structure/boulder,
/turf/template_noop,
/area/template_noop)
"g" = (
/obj/effect/decal/cleanable/dirt,
/turf/template_noop,
/area/template_noop)
"j" = (
/obj/effect/decal/cleanable/soot,
/turf/template_noop,
/area/template_noop)
"k" = (
/obj/item/device/radio/intercom{
	dir = 4;
	name = "Station Intercom (General)";
	pixel_x = 27
	},
/obj/structure/bed/chair/shuttle{
	dir = 1
	},
/obj/item/weapon/paper/crumpled{
	info = "The rambling journal of a man whose pod never made it back to Central Command. The last entry reads, 'Dear journal, I think this is it for me. I really wish I took the shuttle...'"
	},
/obj/effect/decal/cleanable/dirt,
/obj/abstract/loot_spawner/entertainment,
/turf/simulated/floor/shuttle,
/area/ruin)
"m" = (
/turf/template_noop,
/area/template_noop)
"p" = (
/turf/simulated/wall/shuttle,
/area/ruin)
"q" = (
/obj/structure/grille,
/obj/structure/window/reinforced{
	dir = 8
	},
/obj/structure/window/reinforced,
/obj/item/weapon/shard{
	icon_state = "small";
	pixel_x = 5;
	pixel_y = -5
	},
/obj/item/weapon/shard,
/turf/simulated/floor/shuttle/plating,
/area/ruin)
"u" = (
/obj/machinery/media/receiver/boombox/wallmount/shuttle{
	pixel_x = -32
	},
/obj/structure/bed/chair/shuttle{
	dir = 1
	},
/obj/effect/decal/remains/human,
/obj/item/clothing/head/dunce_cap{
	pixel_y = 8
	},
/obj/effect/decal/cleanable/dirt,
/turf/simulated/floor/shuttle,
/area/ruin)
"x" = (
/obj/structure/shuttle/engine/propulsion/left,
/obj/effect/decal/cleanable/soot,
/turf/simulated/floor/plating,
/area/ruin)
"z" = (
/obj/structure/shuttle/engine/propulsion/right,
/obj/effect/decal/cleanable/soot,
/turf/simulated/floor/plating,
/area/ruin)
"C" = (
/obj/effect/decal/cleanable/dirt,
/obj/item/weapon/storage/fancy/donut_box/empty,
/turf/template_noop,
/area/template_noop)
"G" = (
/obj/effect/decal/cleanable/soot,
/obj/effect/decal/cleanable/soot,
/obj/item/stack/rods,
/turf/template_noop,
/area/template_noop)
"J" = (
/obj/effect/decal/cleanable/dirt,
/obj/item/stack/rods,
/turf/template_noop,
/area/template_noop)
"R" = (
/obj/item/device/flashlight/flare,
/turf/template_noop,
/area/template_noop)
"Y" = (
/obj/structure/boulder,
/obj/effect/decal/cleanable/dirt,
/turf/template_noop,
/area/template_noop)

(1,1,1) = {"
m
m
m
m
m
m
m
m
m
m
m
m
m
m
"}
(2,1,1) = {"
m
m
m
m
m
m
m
Y
m
m
m
m
m
m
"}
(3,1,1) = {"
a
p
p
x
j
C
j
g
e
m
Y
m
m
m
"}
(4,1,1) = {"
q
u
k
c
j
j
R
m
m
m
m
R
J
m
"}
(5,1,1) = {"
b
p
p
z
G
j
j
j
m
m
g
e
m
m
"}
(6,1,1) = {"
m
m
m
m
f
f
m
m
m
m
m
m
m
m
"}
(7,1,1) = {"
m
m
m
m
m
m
m
m
m
m
m
m
m
m
"}
