//MAP CONVERTED BY dmm2tgm.py THIS HEADER COMMENT PREVENTS RECONVERSION, DO NOT REMOVE
"a" = (
/turf/simulated/wall/mineral/wood,
/area/surface/jungle)
"b" = (
/obj/structure/flora/ausbushes/grassybush,
/turf/unsimulated/floor/jungle/grass,
/area/surface/jungle)
"c" = (
/obj/structure/grille,
/obj/structure/window{
	dir = 4
	},
/obj/structure/window{
	dir = 8
	},
/obj/structure/window{
	dir = 1
	},
/turf/simulated/floor/plating/deck,
/area/surface/jungle)
"d" = (
/obj/structure/grille,
/obj/structure/window{
	dir = 4
	},
/obj/structure/window{
	dir = 8
	},
/obj/structure/window,
/turf/simulated/floor/plating/deck,
/area/surface/jungle)
"f" = (
/obj/structure/table/woodentable,
/obj/item/weapon/book/manual/engineering_hacking{
	pixel_x = 7;
	pixel_y = 3
	},
/obj/item/toy/cards{
	pixel_x = -9;
	pixel_y = -1
	},
/turf/simulated/floor/wood,
/area/surface/jungle)
"i" = (
/obj/structure/flora/ausbushes/ppflowers,
/turf/unsimulated/floor/jungle/grass,
/area/surface/jungle)
"j" = (
/obj/structure/bed/chair/wood/normal,
/turf/simulated/floor/wood,
/area/surface/jungle)
"m" = (
/obj/structure/grille,
/obj/structure/window,
/obj/structure/window{
	dir = 1
	},
/obj/structure/window{
	dir = 8
	},
/obj/structure/window{
	dir = 4
	},
/turf/simulated/floor/plating/deck,
/area/surface/jungle)
"n" = (
/obj/structure/grille,
/obj/structure/window,
/obj/structure/window{
	dir = 1
	},
/obj/structure/window{
	dir = 8
	},
/turf/simulated/floor/plating/deck,
/area/surface/jungle)
"o" = (
/obj/structure/table/woodentable,
/obj/item/weapon/paper{
	pixel_x = 7;
	pixel_y = -4
	},
/obj/item/weapon/pen/quill{
	pixel_x = -7;
	pixel_y = 3;
	color = "#DD3333"
	},
/obj/item/weapon/paper{
	pixel_x = 7;
	pixel_y = 5
	},
/turf/simulated/floor/wood,
/area/surface/jungle)
"q" = (
/obj/structure/flora/ausbushes/sparsegrass,
/turf/unsimulated/floor/jungle/grass,
/area/surface/jungle)
"r" = (
/obj/structure/closet/cabinet,
/obj/item/clothing/under/color/prisoner,
/obj/item/clothing/under/color/prisoner,
/turf/simulated/floor/wood,
/area/surface/jungle)
"u" = (
/turf/unsimulated/floor/jungle/dirt,
/area/surface/jungle)
"v" = (
/obj/structure/bed,
/obj/item/weapon/bedsheet/green,
/obj/structure/curtain/open/bed,
/turf/simulated/floor/wood,
/area/surface/jungle)
"w" = (
/obj/structure/flora/ausbushes/genericbush,
/turf/unsimulated/floor/jungle/grass,
/area/surface/jungle)
"z" = (
/obj/machinery/space_heater/campfire,
/obj/machinery/cooking/grill/spit,
/turf/unsimulated/floor/jungle/dirt,
/area/surface/jungle)
"B" = (
/turf/unsimulated/floor/jungle/grass,
/area/surface/jungle)
"F" = (
/turf/simulated/floor/wood,
/area/surface/jungle)
"N" = (
/obj/structure/table/woodentable,
/obj/item/weapon/hatchet{
	pixel_y = 7;
	pixel_x = -3
	},
/obj/item/weapon/reagent_containers/glass/mortar{
	pixel_x = 5;
	pixel_y = -5
	},
/turf/simulated/floor/wood,
/area/surface/jungle)
"O" = (
/obj/structure/grille,
/obj/structure/window,
/obj/structure/window{
	dir = 1
	},
/obj/structure/window{
	dir = 4
	},
/turf/simulated/floor/plating/deck,
/area/surface/jungle)
"P" = (
/obj/structure/grille,
/obj/structure/window,
/obj/structure/window{
	dir = 1
	},
/turf/simulated/floor/plating/deck,
/area/surface/jungle)
"R" = (
/obj/structure/table/woodentable,
/turf/simulated/floor/wood,
/area/surface/jungle)
"S" = (
/obj/machinery/door/mineral/wood{
	name = "Wooden Door"
	},
/turf/simulated/floor/wood,
/area/surface/jungle)
"T" = (
/obj/structure/table/woodentable,
/obj/item/weapon/reagent_containers/food/drinks/drinkingglass,
/turf/simulated/floor/wood,
/area/surface/jungle)
"X" = (
/obj/structure/reagent_dispensers/watertank,
/turf/simulated/floor/wood,
/area/surface/jungle)
"Z" = (
/obj/structure/grille,
/obj/structure/window{
	dir = 4
	},
/obj/structure/window{
	dir = 8
	},
/obj/structure/window,
/obj/structure/window{
	dir = 1
	},
/turf/simulated/floor/plating/deck,
/area/surface/jungle)

(1,1,1) = {"
w
w
u
B
b
b
b
"}
(2,1,1) = {"
a
Z
S
a
a
a
a
"}
(3,1,1) = {"
n
X
F
F
j
f
m
"}
(4,1,1) = {"
P
F
F
F
F
F
a
"}
(5,1,1) = {"
O
T
F
F
F
F
a
"}
(6,1,1) = {"
a
a
S
a
R
N
a
"}
(7,1,1) = {"
n
r
F
a
c
d
a
"}
(8,1,1) = {"
P
F
F
a
i
B
i
"}
(9,1,1) = {"
O
v
o
a
B
z
B
"}
(10,1,1) = {"
a
c
d
a
q
B
B
"}
