//MAP CONVERTED BY dmm2tgm.py THIS HEADER COMMENT PREVENTS RECONVERSION, DO NOT REMOVE
"a" = (
/turf/unsimulated/floor/jungle/dirt,
/area/surface/jungle)
"e" = (
/obj/structure/closet/cabinet,
/obj/item/clothing/head/wizard/clown,
/obj/item/clothing/suit/wizrobe/marisa,
/turf/simulated/floor/wood,
/area/surface/jungle)
"f" = (
/obj/structure/bed/chair/wood/normal{
	dir = 4
	},
/turf/simulated/floor/wood,
/area/surface/jungle)
"h" = (
/turf/simulated/floor/wood,
/area/surface/jungle)
"j" = (
/obj/structure/flora/tree/shitty,
/turf/unsimulated/floor/jungle/grass,
/area/surface/jungle)
"k" = (
/obj/structure/grille,
/obj/structure/window{
	dir = 4
	},
/obj/structure/window{
	dir = 8
	},
/turf/simulated/floor/plating/deck,
/area/surface/jungle)
"l" = (
/obj/effect/decal/cleanable/campfire,
/obj/structure/reagent_dispensers/cauldron{
	name = "Witch's cauldron"
	},
/turf/unsimulated/floor/jungle/dirt,
/area/surface/jungle)
"m" = (
/turf/unsimulated/floor/jungle/grass,
/area/surface/jungle)
"p" = (
/mob/living/complex_animal/frog/poison,
/obj/structure/flora/ausbushes/sunnybush,
/turf/unsimulated/floor/jungle/grass,
/area/surface/jungle)
"q" = (
/obj/structure/grille,
/obj/structure/window{
	dir = 4
	},
/obj/structure/window{
	dir = 8
	},
/obj/structure/window,
/turf/simulated/floor/plating/deck,
/area/surface/jungle)
"s" = (
/obj/structure/flora/ausbushes/lavendergrass,
/turf/unsimulated/floor/jungle/grass,
/area/surface/jungle)
"t" = (
/turf/simulated/wall/mineral/wood,
/area/surface/jungle)
"y" = (
/obj/structure/bed,
/obj/item/weapon/bedsheet/purple,
/turf/simulated/floor/wood,
/area/surface/jungle)
"z" = (
/obj/structure/grille,
/obj/structure/window{
	dir = 4
	},
/obj/structure/window{
	dir = 8
	},
/obj/structure/window{
	dir = 1
	},
/turf/simulated/floor/plating/deck,
/area/surface/jungle)
"B" = (
/obj/structure/flora/ausbushes/sunnybush,
/turf/unsimulated/floor/jungle/grass,
/area/surface/jungle)
"D" = (
/obj/structure/table/woodentable,
/obj/item/weapon/reagent_containers/glass/mortar,
/obj/item/weapon/reagent_containers/food/drinks/drinkingglass{
	pixel_y = 7;
	pixel_x = 2
	},
/obj/item/weapon/reagent_containers/food/drinks/drinkingglass{
	pixel_y = 4;
	pixel_x = -8
	},
/obj/item/weapon/reagent_containers/food/drinks/drinkingglass{
	pixel_y = 8;
	pixel_x = 11
	},
/turf/simulated/floor/wood,
/area/surface/jungle)
"J" = (
/obj/structure/table/woodentable,
/obj/item/potion/fullness,
/obj/item/potion/paralysis{
	pixel_y = 11;
	pixel_x = 10
	},
/obj/item/potion/speed{
	pixel_y = 10;
	pixel_x = -6
	},
/turf/simulated/floor/wood,
/area/surface/jungle)
"L" = (
/mob/living/complex_animal/frog,
/obj/structure/flora/ausbushes/sparsegrass,
/turf/unsimulated/floor/jungle/grass,
/area/surface/jungle)
"M" = (
/mob/living/complex_animal/frog,
/obj/structure/flora/ausbushes/lavendergrass,
/turf/unsimulated/floor/jungle/grass,
/area/surface/jungle)
"N" = (
/mob/living/complex_animal/frog/poison,
/turf/unsimulated/floor/jungle/grass,
/area/surface/jungle)
"O" = (
/obj/machinery/door/mineral/wood{
	name = "Wooden Door"
	},
/turf/simulated/floor/plating/deck,
/area/surface/jungle)
"R" = (
/obj/structure/flora/ausbushes/sparsegrass,
/turf/unsimulated/floor/jungle/grass,
/area/surface/jungle)
"U" = (
/obj/structure/table/woodentable,
/obj/item/weapon/reagent_containers/food/snacks/grown/berries/jungle,
/obj/item/weapon/reagent_containers/food/snacks/grown/berries/jungle{
	pixel_x = 5
	},
/obj/item/weapon/reagent_containers/food/snacks/grown/berries/jungle{
	pixel_x = -4
	},
/obj/item/weapon/reagent_containers/food/snacks/grown/berries/jungle{
	pixel_x = -6;
	pixel_y = 10
	},
/obj/item/weapon/reagent_containers/food/snacks/grown/berries/jungle{
	pixel_x = 6;
	pixel_y = 7
	},
/turf/simulated/floor/wood,
/area/surface/jungle)
"V" = (
/obj/structure/flora/jungle_berries,
/turf/unsimulated/floor/jungle/grass,
/area/surface/jungle)
"W" = (
/mob/living/complex_animal/frog,
/turf/unsimulated/floor/jungle/grass,
/area/surface/jungle)
"X" = (
/mob/living/complex_animal/frog/poison,
/obj/structure/flora/ausbushes/sparsegrass,
/turf/unsimulated/floor/jungle/grass,
/area/surface/jungle)

(1,1,1) = {"
R
m
R
W
m
X
R
m
X
m
"}
(2,1,1) = {"
N
V
t
t
t
t
t
L
j
N
"}
(3,1,1) = {"
R
V
t
y
h
e
t
m
m
R
"}
(4,1,1) = {"
s
V
t
f
h
h
O
a
s
m
"}
(5,1,1) = {"
s
V
t
D
U
J
t
a
m
W
"}
(6,1,1) = {"
W
V
t
z
k
q
t
a
s
m
"}
(7,1,1) = {"
m
j
s
s
a
a
a
a
s
m
"}
(8,1,1) = {"
B
m
s
a
l
a
a
a
m
B
"}
(9,1,1) = {"
B
m
M
m
a
m
W
s
m
W
"}
(10,1,1) = {"
m
p
s
s
m
s
j
m
N
B
"}
(11,1,1) = {"
m
s
m
B
m
m
s
m
B
B
"}
