//MAP CONVERTED BY dmm2tgm.py THIS HEADER COMMENT PREVENTS RECONVERSION, DO NOT REMOVE
"a" = (
/obj/structure/flora/tree/shitty,
/turf/unsimulated/floor/jungle/grass,
/area/surface/jungle)
"b" = (
/obj/structure/grille,
/obj/structure/window{
	dir = 1
	},
/obj/structure/window{
	dir = 8
	},
/obj/structure/window{
	dir = 4
	},
/turf/simulated/floor/plating/deck,
/area/surface/jungle)
"c" = (
/mob/living/complex_animal/frog,
/turf/unsimulated/floor/jungle/grass,
/area/surface/jungle)
"d" = (
/obj/machinery/door/mineral/wood,
/turf/simulated/floor/wood,
/area/surface/jungle)
"e" = (
/obj/structure/table/woodentable,
/obj/item/weapon/reagent_containers/food/drinks/drinkingglass,
/obj/item/weapon/reagent_containers/food/drinks/drinkingglass,
/obj/item/weapon/reagent_containers/food/drinks/drinkingglass,
/obj/item/weapon/reagent_containers/food/drinks/drinkingglass,
/obj/item/weapon/reagent_containers/food/drinks/drinkingglass,
/turf/simulated/floor/wood,
/area/surface/jungle)
"i" = (
/obj/structure/flora/jungle_berries,
/turf/unsimulated/floor/jungle/grass,
/area/surface/jungle)
"j" = (
/obj/structure/flora/ausbushes/lavendergrass,
/turf/unsimulated/floor/jungle/grass,
/area/surface/jungle)
"l" = (
/obj/item/weapon/stool/bar,
/turf/unsimulated/floor/jungle/grass,
/area/surface/jungle)
"n" = (
/obj/structure/table/woodentable,
/obj/item/weapon/reagent_containers/food/drinks/soda_cans/gunka_cola{
	pixel_x = -7
	},
/obj/item/weapon/reagent_containers/food/drinks/soda_cans/gunka_cola{
	pixel_y = 6;
	pixel_x = 9
	},
/obj/item/weapon/reagent_containers/food/snacks/grown/berries/jungle,
/obj/item/weapon/reagent_containers/food/snacks/grown/berries/jungle,
/turf/simulated/floor/wood,
/area/surface/jungle)
"q" = (
/obj/structure/table/woodentable,
/obj/item/weapon/reagent_containers/food/drinks/bottle/vodka{
	pixel_x = -6
	},
/obj/item/weapon/reagent_containers/food/drinks/bottle/limejuice{
	pixel_x = 7
	},
/turf/simulated/floor/wood,
/area/surface/jungle)
"r" = (
/obj/structure/flora/ausbushes/grassybush,
/turf/unsimulated/floor/jungle/grass,
/area/surface/jungle)
"t" = (
/mob/living/complex_animal/parrot{
	builtin_phrases = list("Hi.","Hello!","Cracker?","BAWWWWK george mellons griffing me!","Give me a drink, bartender.","Another round!","What the hell am I drinking?","And stay out!","No tabs - cash up front!");
	name = "Mallory";
	mob_max_age = 45000;
	food_per_tick = 0.0
	},
/turf/simulated/floor/wood,
/area/surface/jungle)
"u" = (
/obj/structure/table/woodentable,
/obj/item/weapon/reagent_containers/food/drinks/bottle/tequila{
	pixel_x = 4
	},
/obj/item/weapon/reagent_containers/food/drinks/bottle/rum{
	pixel_x = -9
	},
/turf/simulated/floor/wood,
/area/surface/jungle)
"v" = (
/obj/structure/table/woodentable,
/turf/simulated/floor/wood,
/area/surface/jungle)
"w" = (
/turf/simulated/floor/wood,
/area/surface/jungle)
"x" = (
/obj/structure/flora/ausbushes/sunnybush,
/turf/unsimulated/floor/jungle/grass,
/area/surface/jungle)
"A" = (
/obj/structure/flora/ausbushes/ppflowers,
/turf/unsimulated/floor/jungle/grass,
/area/surface/jungle)
"E" = (
/obj/structure/closet/crate/freezer,
/obj/item/ice_crystal,
/obj/item/ice_crystal,
/obj/item/ice_crystal,
/obj/item/ice_crystal,
/obj/item/ice_crystal,
/obj/item/ice_crystal,
/obj/item/ice_crystal,
/turf/simulated/floor/wood,
/area/surface/jungle)
"F" = (
/obj/structure/table/woodentable,
/obj/item/weapon/spacecash/c10,
/obj/item/weapon/spacecash/c10,
/obj/item/weapon/spacecash/c10,
/turf/simulated/floor/wood,
/area/surface/jungle)
"I" = (
/obj/structure/flora/ausbushes/leafybush,
/turf/unsimulated/floor/jungle/grass,
/area/surface/jungle)
"J" = (
/obj/structure/flora/ausbushes/grassybush,
/mob/living/complex_animal/frog,
/turf/unsimulated/floor/jungle/grass,
/area/surface/jungle)
"L" = (
/turf/simulated/wall/mineral/wood,
/area/surface/jungle)
"M" = (
/obj/structure/flora/ausbushes/leafybush,
/mob/living/complex_animal/frog,
/turf/unsimulated/floor/jungle/grass,
/area/surface/jungle)
"Q" = (
/obj/structure/grille,
/obj/structure/window{
	dir = 8
	},
/obj/structure/window{
	dir = 4
	},
/obj/structure/window,
/turf/simulated/floor/plating/deck,
/area/surface/jungle)
"U" = (
/obj/structure/hanging_lantern/dim,
/turf/simulated/floor/wood,
/area/surface/jungle)
"V" = (
/turf/unsimulated/floor/jungle/grass,
/area/surface/jungle)
"Y" = (
/obj/structure/table/woodentable,
/obj/item/weapon/reagent_containers/food/drinks/shaker{
	pixel_x = -7
	},
/obj/item/weapon/reagent_containers/food/drinks/shaker{
	pixel_x = 11
	},
/obj/structure/hanging_lantern/dim{
	dir = 1
	},
/turf/simulated/floor/wood,
/area/surface/jungle)
"Z" = (
/obj/structure/reagent_dispensers/brewerybeerkeg/contraband,
/obj/structure/table/woodentable,
/turf/simulated/floor/wood,
/area/surface/jungle)

(1,1,1) = {"
V
I
I
V
V
V
I
J
V
V
x
V
x
"}
(2,1,1) = {"
V
a
V
M
I
V
V
V
V
a
V
x
x
"}
(3,1,1) = {"
V
V
L
L
d
L
L
b
Q
L
V
V
x
"}
(4,1,1) = {"
j
V
L
e
w
q
L
Y
w
v
l
V
V
"}
(5,1,1) = {"
V
j
L
n
w
u
L
e
w
F
l
V
V
"}
(6,1,1) = {"
j
V
L
E
w
w
d
t
w
v
l
c
V
"}
(7,1,1) = {"
V
c
L
w
w
U
L
b
Q
L
V
V
A
"}
(8,1,1) = {"
V
j
L
Z
Z
Z
L
i
i
i
V
A
A
"}
(9,1,1) = {"
j
V
L
L
L
L
L
i
V
V
V
V
V
"}
(10,1,1) = {"
V
V
a
V
A
V
V
c
V
A
V
a
V
"}
(11,1,1) = {"
j
V
V
V
V
V
r
r
A
V
V
V
V
"}
