//MAP CONVERTED BY dmm2tgm.py THIS HEADER COMMENT PREVENTS RECONVERSION, DO NOT REMOVE
"a" = (
/turf/unsimulated/floor/jungle/grass,
/area/surface/jungle)
"g" = (
/obj/machinery/space_heater/campfire{
	burntime = 5
	},
/obj/machinery/cooking/grill/spit,
/turf/unsimulated/floor/jungle/dirt,
/area/surface/jungle)
"D" = (
/obj/structure/flora/ausbushes/fullgrass,
/turf/unsimulated/floor/jungle/grass,
/area/surface/jungle)
"E" = (
/obj/structure/flora/ausbushes/brflowers,
/turf/unsimulated/floor/jungle/grass,
/area/surface/jungle)
"M" = (
/turf/unsimulated/floor/jungle/dirt,
/area/surface/jungle)
"N" = (
/obj/structure/flora/ausbushes/stalkybush,
/turf/unsimulated/floor/jungle/grass,
/area/surface/jungle)

(1,1,1) = {"
E
a
D
a
N
"}
(2,1,1) = {"
a
E
M
D
a
"}
(3,1,1) = {"
a
M
g
M
a
"}
(4,1,1) = {"
a
D
M
a
D
"}
(5,1,1) = {"
N
a
a
D
a
"}
