//MAP CONVERTED BY dmm2tgm.py THIS HEADER COMMENT PREVENTS RECONVERSION, DO NOT REMOVE
"a" = (
/obj/structure/flora/ausbushes/fullgrass,
/turf/unsimulated/floor/jungle/grass,
/area/surface/jungle)
"g" = (
/obj/structure/flora/tree/shitty,
/turf/unsimulated/floor/jungle/grass,
/area/surface/jungle)
"j" = (
/obj/item/folding_chair,
/obj/effect/landmark/corpse/civilian,
/obj/effect/decal/cleanable/blood/gibs/up{
	color = "#A10808"
	},
/turf/unsimulated/floor/jungle/grass,
/area/surface/jungle)
"l" = (
/obj/structure/table/woodentable/poker,
/obj/item/toy/singlecard{
	icon_state = "sc_4 of Hearts"
	},
/obj/item/toy/singlecard{
	pixel_x = 6;
	icon_state = "sc_5 of Spades"
	},
/turf/unsimulated/floor/jungle/grass,
/area/surface/jungle)
"u" = (
/turf/unsimulated/floor/jungle/grass,
/area/surface/jungle)
"G" = (
/obj/structure/table/woodentable/poker,
/obj/item/toy/singlecard{
	pixel_y = 5;
	pixel_x = 7;
	icon_state = "sc_Ace of Hearts"
	},
/obj/item/toy/singlecard{
	pixel_y = 5;
	pixel_x = -17;
	icon_state = "sc_Ace of Clubs"
	},
/obj/item/toy/singlecard{
	pixel_y = 5;
	pixel_x = -7;
	icon_state = "sc_Ace of Diamonds"
	},
/turf/unsimulated/floor/jungle/grass,
/area/surface/jungle)
"J" = (
/obj/structure/table/woodentable/poker,
/obj/item/toy/singlecard{
	pixel_y = 5;
	pixel_x = -9;
	icon_state = "sc_Ace of Hearts"
	},
/obj/item/toy/singlecard{
	pixel_y = 5;
	pixel_x = 6;
	icon_state = "sc_Ace of Spades"
	},
/obj/item/toy/cards{
	pixel_y = -9;
	pixel_x = 15
	},
/turf/unsimulated/floor/jungle/grass,
/area/surface/jungle)
"R" = (
/obj/structure/bed/chair/folding{
	dir = 1
	},
/obj/item/ammo_casing/a357{
	pixel_x = 10;
	pixel_y = 6
	},
/obj/item/ammo_casing/a357{
	pixel_x = 5;
	pixel_y = 2
	},
/turf/unsimulated/floor/jungle/grass,
/area/surface/jungle)
"W" = (
/obj/structure/table/woodentable/poker,
/obj/item/toy/singlecard{
	pixel_x = 6;
	icon_state = "sc_8 of Hearts"
	},
/obj/item/toy/singlecard{
	icon_state = "sc_7 of Spades"
	},
/obj/item/toy/singlecard{
	pixel_x = -17;
	icon_state = "sc_6 of Diamonds"
	},
/turf/unsimulated/floor/jungle/grass,
/area/surface/jungle)

(1,1,1) = {"
a
a
u
u
a
u
"}
(2,1,1) = {"
u
j
J
l
R
a
"}
(3,1,1) = {"
a
u
G
W
u
u
"}
(4,1,1) = {"
u
g
u
u
a
u
"}
(5,1,1) = {"
u
a
u
a
u
u
"}
