//MAP CONVERTED BY dmm2tgm.py THIS HEADER COMMENT PREVENTS RECONVERSION, DO NOT REMOVE
"a" = (
/turf/unsimulated/floor/jungle/concrete,
/area/surface/jungle)
"b" = (
/obj/effect/decal/warning_stripes{
	icon_state = "loading_area";
	tag = "icon-loading_area"
	},
/turf/unsimulated/floor/jungle/concrete,
/area/surface/jungle)
"d" = (
/obj/effect/decal/warning_stripes{
	dir = 8;
	icon_state = "warning_corner"
	},
/turf/unsimulated/floor/jungle/concrete,
/area/surface/jungle)
"f" = (
/obj/structure/fence/cut/medium{
	dir = 4
	},
/turf/unsimulated/floor/jungle/path_plated,
/area/surface/jungle)
"g" = (
/obj/structure/flora/ausbushes/stalkybush,
/turf/unsimulated/floor/jungle/grass,
/area/surface/jungle)
"h" = (
/turf/unsimulated/floor/jungle/path,
/area/surface/jungle)
"k" = (
/obj/structure/fence,
/turf/unsimulated/floor/jungle/path,
/area/surface/jungle)
"l" = (
/obj/structure/rack,
/obj/item/weapon/grown/log/tree,
/obj/item/weapon/grown/log/tree,
/obj/item/weapon/grown/log/tree,
/obj/item/weapon/grown/log/tree,
/obj/item/weapon/grown/log/tree,
/turf/unsimulated/floor/jungle/grass,
/area/surface/jungle)
"m" = (
/obj/structure/fence/cut/medium,
/turf/unsimulated/floor/jungle/path,
/area/surface/jungle)
"o" = (
/obj/effect/decal/warning_stripes{
	dir = 1;
	icon_state = "warning"
	},
/turf/unsimulated/floor/jungle/concrete,
/area/surface/jungle)
"s" = (
/obj/structure/fence/corner,
/turf/unsimulated/floor/jungle/path_plated,
/area/surface/jungle)
"t" = (
/obj/structure/fence/cut/large{
	dir = 4
	},
/turf/unsimulated/floor/jungle/path,
/area/surface/jungle)
"w" = (
/turf/unsimulated/floor/jungle/grass,
/area/surface/jungle)
"x" = (
/obj/structure/fence/cut/large{
	dir = 4
	},
/turf/unsimulated/floor/jungle/path_plated,
/area/surface/jungle)
"z" = (
/turf/unsimulated/floor/jungle/dirt,
/area/surface/jungle)
"B" = (
/obj/item/ammo_casing/c38,
/obj/item/ammo_casing/c38{
	pixel_y = -6;
	pixel_x = -3
	},
/obj/item/ammo_casing/c38{
	pixel_x = 7;
	pixel_y = -5
	},
/obj/item/ammo_casing/c38{
	pixel_x = 6;
	pixel_y = 7
	},
/turf/unsimulated/floor/jungle/grass,
/area/surface/jungle)
"C" = (
/obj/structure/flora/ausbushes/reedbush,
/turf/unsimulated/floor/jungle/grass,
/area/surface/jungle)
"D" = (
/obj/item/ammo_casing/c38,
/obj/item/ammo_casing/c38{
	pixel_x = 6;
	pixel_y = 10
	},
/obj/item/ammo_casing/c38{
	pixel_x = -6;
	pixel_y = -3
	},
/obj/item/ammo_casing/c38{
	pixel_x = -10;
	pixel_y = 6
	},
/obj/item/ammo_casing/c38{
	pixel_y = -8;
	pixel_x = 5
	},
/obj/item/ammo_casing/c38{
	pixel_x = 12;
	pixel_y = 8
	},
/turf/unsimulated/floor/jungle/path_plated,
/area/surface/jungle)
"G" = (
/obj/structure/rack,
/obj/item/weapon/hatchet,
/obj/item/weapon/hatchet{
	pixel_x = -3;
	pixel_y = -4
	},
/turf/unsimulated/floor/jungle/grass,
/area/surface/jungle)
"H" = (
/obj/structure/fence/corner{
	dir = 8
	},
/turf/unsimulated/floor/jungle/path_plated,
/area/surface/jungle)
"I" = (
/obj/structure/flora/tree_stump,
/turf/unsimulated/floor/jungle/grass,
/area/surface/jungle)
"J" = (
/obj/structure/fence{
	dir = 4
	},
/turf/unsimulated/floor/jungle/path_plated,
/area/surface/jungle)
"K" = (
/obj/effect/decal/warning_stripes{
	dir = 8;
	icon_state = "warning"
	},
/turf/unsimulated/floor/jungle/concrete,
/area/surface/jungle)
"L" = (
/obj/structure/flora/ausbushes/genericbush,
/turf/unsimulated/floor/jungle/grass,
/area/surface/jungle)
"M" = (
/obj/structure/fence,
/turf/unsimulated/floor/jungle/path_plated,
/area/surface/jungle)
"N" = (
/obj/structure/rack,
/obj/item/weapon/hatchet,
/obj/item/weapon/hatchet{
	pixel_x = -5;
	pixel_y = -3
	},
/turf/unsimulated/floor/jungle/grass,
/area/surface/jungle)
"O" = (
/obj/structure/fence/cut/medium,
/turf/unsimulated/floor/jungle/path_plated,
/area/surface/jungle)
"P" = (
/obj/structure/flora/ausbushes/leafybush,
/turf/unsimulated/floor/jungle/grass,
/area/surface/jungle)
"R" = (
/turf/unsimulated/floor/jungle/path_plated,
/area/surface/jungle)
"S" = (
/obj/effect/decal/warning_stripes{
	dir = 1;
	icon_state = "warning_corner";
	tag = "icon-warning_corner (NORTH)"
	},
/turf/unsimulated/floor/jungle/concrete,
/area/surface/jungle)
"T" = (
/obj/structure/fence{
	dir = 4
	},
/turf/unsimulated/floor/jungle/path,
/area/surface/jungle)
"U" = (
/obj/effect/decal/warning_stripes{
	dir = 4;
	icon_state = "warning_corner";
	tag = "icon-warning_corner (EAST)"
	},
/turf/unsimulated/floor/jungle/concrete,
/area/surface/jungle)
"X" = (
/obj/effect/decal/warning_stripes{
	dir = 4;
	icon_state = "warning"
	},
/turf/unsimulated/floor/jungle/concrete,
/area/surface/jungle)
"Y" = (
/mob/living/complex_animal/panther{
	health = 0;
	ticks_dead = -1800;
	stat = 2;
	icon_state = "panther_dead"
	},
/turf/unsimulated/floor/jungle/grass,
/area/surface/jungle)
"Z" = (
/obj/effect/decal/warning_stripes{
	icon_state = "warning";
	tag = "icon-warning"
	},
/turf/unsimulated/floor/jungle/concrete,
/area/surface/jungle)

(1,1,1) = {"
w
P
w
w
P
g
H
m
M
k
M
O
k
M
H
"}
(2,1,1) = {"
P
w
I
w
w
g
J
z
a
X
X
X
a
U
J
"}
(3,1,1) = {"
w
w
w
C
w
l
J
Z
a
a
a
z
a
z
x
"}
(4,1,1) = {"
w
w
g
w
w
l
t
a
z
a
a
a
a
o
J
"}
(5,1,1) = {"
g
w
w
Y
w
w
J
Z
a
a
z
a
a
o
T
"}
(6,1,1) = {"
w
I
w
w
w
w
J
a
z
a
a
a
a
a
x
"}
(7,1,1) = {"
w
w
w
I
w
B
h
Z
a
a
a
a
a
o
J
"}
(8,1,1) = {"
w
w
C
w
w
w
R
b
a
z
a
a
a
o
J
"}
(9,1,1) = {"
w
Y
w
C
w
w
D
z
a
a
a
a
a
o
T
"}
(10,1,1) = {"
w
g
w
w
w
L
T
Z
a
a
a
a
z
a
J
"}
(11,1,1) = {"
w
w
w
w
I
G
f
a
a
a
a
a
a
o
f
"}
(12,1,1) = {"
w
I
w
g
w
N
J
d
a
z
a
K
a
S
J
"}
(13,1,1) = {"
w
w
w
w
w
w
s
M
O
k
M
M
m
k
s
"}
