//MAP CONVERTED BY dmm2tgm.py THIS HEADER COMMENT PREVENTS RECONVERSION, DO NOT REMOVE
"a" = (
/turf/unsimulated/floor/jungle/grass,
/area/surface/jungle)
"c" = (
/obj/structure/flora/tree/shitty,
/turf/unsimulated/floor/jungle/grass,
/area/surface/jungle)
"d" = (
/obj/structure/flora/ausbushes/sunnybush,
/turf/unsimulated/floor/jungle/grass,
/area/surface/jungle)
"k" = (
/obj/structure/shuttle/engine/propulsion/right,
/obj/structure/shuttle/diag_wall/smooth{
	dir = 4
	},
/turf/simulated/floor/plating,
/area/surface/jungle)
"n" = (
/turf/unsimulated/floor/jungle/dirt,
/area/surface/jungle)
"p" = (
/obj/structure/flora/ausbushes/pointybush,
/turf/unsimulated/floor/jungle/grass,
/area/surface/jungle)
"q" = (
/obj/structure/window/reinforced{
	dir = 8
	},
/obj/structure/grille/broken,
/obj/structure/bed/chair/shuttle{
	dir = 4
	},
/turf/simulated/floor/shuttle/plating,
/area/surface/jungle)
"s" = (
/obj/structure/shuttle/engine/propulsion/left,
/obj/structure/shuttle/diag_wall/smooth,
/turf/simulated/floor/plating,
/area/surface/jungle)
"v" = (
/turf/simulated/floor/shuttle,
/area/surface/jungle)
"A" = (
/obj/effect/landmark/corpse/assistant/robust,
/obj/effect/decal/cleanable/blood/gibs/up{
	color = "#772222"
	},
/obj/structure/flora/ausbushes/fernybush,
/turf/unsimulated/floor/jungle/grass,
/area/surface/jungle)
"C" = (
/obj/structure/shuttle/diag_wall/smooth{
	dir = 8
	},
/turf/unsimulated/floor/jungle/dirt,
/area/surface/jungle)
"F" = (
/obj/machinery/light/small/broken{
	dir = 8
	},
/obj/structure/bed/chair/shuttle{
	dir = 8
	},
/turf/simulated/floor/shuttle,
/area/surface/jungle)
"G" = (
/obj/structure/flora/ausbushes/fernybush,
/turf/unsimulated/floor/jungle/grass,
/area/surface/jungle)
"H" = (
/turf/simulated/wall/shuttle,
/area/surface/jungle)
"I" = (
/obj/structure/flora/jungle_berries,
/turf/unsimulated/floor/jungle/grass,
/area/surface/jungle)
"O" = (
/obj/structure/flora/ausbushes/sparsegrass,
/turf/unsimulated/floor/jungle/grass,
/area/surface/jungle)
"P" = (
/obj/structure/shuttle/diag_wall/smooth{
	dir = 1
	},
/turf/unsimulated/floor/jungle/dirt,
/area/surface/jungle)
"U" = (
/obj/effect/decal/cleanable/blood/gibs/up{
	color = "#772222"
	},
/turf/unsimulated/floor/jungle/dirt,
/area/surface/jungle)
"Y" = (
/obj/machinery/door/unpowered/shuttle,
/turf/simulated/floor/shuttle,
/area/surface/jungle)

(1,1,1) = {"
a
a
G
a
G
a
p
a
p
p
a
"}
(2,1,1) = {"
G
a
c
C
H
H
s
n
n
O
a
"}
(3,1,1) = {"
a
A
U
q
v
F
Y
n
n
n
p
"}
(4,1,1) = {"
a
I
a
P
H
H
k
n
n
O
O
"}
(5,1,1) = {"
d
a
I
a
I
a
O
O
a
O
O
"}
