//MAP CONVERTED BY dmm2tgm.py THIS HEADER COMMENT PREVENTS RECONVERSION, DO NOT REMOVE
"a" = (
/obj/structure/flora/tree/shitty,
/turf/unsimulated/floor/jungle/grass,
/area/surface/jungle)
"b" = (
/turf/unsimulated/floor/jungle/grass,
/area/surface/jungle)
"h" = (
/obj/structure/flora/ausbushes/stalkybush,
/turf/unsimulated/floor/jungle/grass,
/area/surface/jungle)
"n" = (
/obj/item/weapon/storage/fancy/beer_box/empty{
	pixel_y = 16;
	pixel_x = -2
	},
/turf/unsimulated/floor/jungle/grass,
/area/surface/jungle)
"x" = (
/obj/structure/flora/ausbushes/reedbush,
/turf/unsimulated/floor/jungle/grass,
/area/surface/jungle)
"z" = (
/obj/structure/flora/ausbushes/sunnybush,
/turf/unsimulated/floor/jungle/grass,
/area/surface/jungle)
"G" = (
/turf/unsimulated/floor/jungle/water_deep,
/area/surface/jungle)
"I" = (
/obj/structure/flora/ausbushes/fullgrass,
/turf/unsimulated/floor/jungle/grass,
/area/surface/jungle)
"O" = (
/obj/structure/bed/chair/folding,
/turf/unsimulated/floor/jungle/grass,
/area/surface/jungle)
"P" = (
/obj/structure/table/holotable/wood,
/obj/item/weapon/reagent_containers/food/drinks/beer{
	pixel_x = -9
	},
/obj/item/ashtray/glass{
	pixel_x = 4
	},
/obj/item/trash/cigbutt/cigarbutt{
	pixel_x = 5;
	pixel_y = 3
	},
/turf/unsimulated/floor/jungle/grass,
/area/surface/jungle)
"R" = (
/turf/unsimulated/floor/jungle/water,
/area/surface/jungle)

(1,1,1) = {"
b
b
I
b
h
b
b
I
b
b
b
"}
(2,1,1) = {"
h
a
b
z
b
x
b
a
b
I
h
"}
(3,1,1) = {"
b
I
b
x
R
R
R
x
h
I
b
"}
(4,1,1) = {"
b
b
b
R
R
G
R
R
b
b
b
"}
(5,1,1) = {"
b
O
b
R
G
G
G
R
x
b
b
"}
(6,1,1) = {"
b
P
n
R
R
G
G
R
b
b
b
"}
(7,1,1) = {"
b
b
b
x
R
G
G
R
b
b
I
"}
(8,1,1) = {"
b
I
b
b
R
R
R
R
x
a
b
"}
(9,1,1) = {"
b
I
b
I
x
b
x
b
b
I
b
"}
(10,1,1) = {"
I
b
h
I
a
b
b
I
b
I
b
"}
(11,1,1) = {"
b
b
b
b
b
h
b
b
b
b
h
"}
