//MAP CONVERTED BY dmm2tgm.py THIS HEADER COMMENT PREVENTS RECONVERSION, DO NOT REMOVE
"a" = (
/turf/unsimulated/floor/jungle/grass,
/area/surface/jungle)
"d" = (
/obj/structure/flora/tree/shitty,
/turf/unsimulated/floor/jungle/grass,
/area/surface/jungle)
"h" = (
/obj/effect/decal/cleanable/blood{
	color = "#772222"
	},
/obj/item/weapon/gun/projectile/hecate/hunting,
/turf/unsimulated/floor/jungle/grass,
/area/surface/jungle)
"i" = (
/obj/structure/flora/ausbushes/ywflowers,
/obj/item/weapon/reagent_containers/food/snacks/meat,
/obj/item/weapon/reagent_containers/food/snacks/meat{
	pixel_x = 7
	},
/obj/item/weapon/reagent_containers/food/snacks/meat{
	pixel_y = -3;
	pixel_x = 7
	},
/obj/item/weapon/reagent_containers/food/snacks/meat{
	pixel_x = -7;
	pixel_y = -4
	},
/obj/item/clothing/head/bearpelt/brown/real{
	pixel_y = 14
	},
/obj/effect/decal/cleanable/blood{
	color = "#772222"
	},
/turf/unsimulated/floor/jungle/grass,
/area/surface/jungle)
"j" = (
/obj/structure/flora/ausbushes/ywflowers,
/obj/effect/decal/cleanable/blood{
	color = "#772222"
	},
/turf/unsimulated/floor/jungle/grass,
/area/surface/jungle)
"l" = (
/obj/effect/decal/cleanable/blood{
	color = "#772222"
	},
/obj/item/ammo_casing/c38,
/obj/item/ammo_casing/c38{
	pixel_x = 6;
	pixel_y = 10
	},
/obj/item/ammo_casing/c38{
	pixel_x = -6;
	pixel_y = -3
	},
/obj/item/ammo_casing/c38{
	pixel_x = -10;
	pixel_y = 6
	},
/mob/living/complex_animal/panther,
/turf/unsimulated/floor/jungle/grass,
/area/surface/jungle)
"t" = (
/obj/effect/decal/cleanable/blood{
	color = "#772222"
	},
/obj/item/ammo_casing/c38{
	pixel_x = 7;
	pixel_y = -5
	},
/obj/item/ammo_casing/c38{
	pixel_y = -8;
	pixel_x = 5
	},
/obj/item/ammo_casing/c38{
	pixel_x = 6;
	pixel_y = 10
	},
/obj/item/ammo_casing/c38{
	pixel_x = 6;
	pixel_y = 7
	},
/obj/effect/landmark/corpse/assistant,
/turf/unsimulated/floor/jungle/grass,
/area/surface/jungle)
"x" = (
/obj/effect/decal/cleanable/blood,
/turf/unsimulated/floor/jungle/grass,
/area/surface/jungle)
"C" = (
/obj/effect/decal/cleanable/blood{
	color = "#772222"
	},
/turf/unsimulated/floor/jungle/grass,
/area/surface/jungle)
"P" = (
/obj/structure/flora/ausbushes/palebush,
/turf/unsimulated/floor/jungle/grass,
/area/surface/jungle)
"R" = (
/obj/structure/flora/ausbushes/ywflowers,
/obj/effect/decal/cleanable/blood{
	color = "#772222"
	},
/obj/item/ammo_casing/c38{
	pixel_x = -10;
	pixel_y = 6
	},
/obj/item/ammo_casing/c38{
	pixel_y = -8;
	pixel_x = 5
	},
/obj/item/ammo_casing/c38{
	pixel_x = -6;
	pixel_y = -3
	},
/turf/unsimulated/floor/jungle/grass,
/area/surface/jungle)
"U" = (
/obj/structure/flora/ausbushes/ywflowers,
/mob/living/complex_animal/panther,
/turf/unsimulated/floor/jungle/grass,
/area/surface/jungle)

(1,1,1) = {"
a
P
a
a
a
"}
(2,1,1) = {"
P
x
d
P
a
"}
(3,1,1) = {"
C
i
t
h
U
"}
(4,1,1) = {"
a
j
R
a
a
"}
(5,1,1) = {"
a
a
l
a
a
"}
