//MAP CONVERTED BY dmm2tgm.py THIS HEADER COMMENT PREVENTS RECONVERSION, DO NOT REMOVE
"a" = (
/obj/structure/flora/jungle_berries,
/turf/unsimulated/floor/jungle/grass,
/area/surface/jungle)
"c" = (
/obj/structure/table/woodentable,
/obj/item/weapon/storage/fancy/beer_box,
/turf/unsimulated/floor/jungle/path,
/area/surface/jungle)
"h" = (
/obj/structure/flora/tree/shitty,
/turf/unsimulated/floor/jungle/grass,
/area/surface/jungle)
"p" = (
/obj/structure/flora/ausbushes/grassybush,
/turf/unsimulated/floor/jungle/grass,
/area/surface/jungle)
"t" = (
/turf/unsimulated/floor/jungle/grass,
/area/surface/jungle)
"u" = (
/obj/structure/flora/ausbushes/stalkybush,
/turf/unsimulated/floor/jungle/grass,
/area/surface/jungle)
"y" = (
/turf/unsimulated/floor/jungle/path,
/area/surface/jungle)
"G" = (
/obj/item/clothing/glasses/sunglasses{
	pixel_y = -5
	},
/obj/structure/table/woodentable,
/obj/item/weapon/lighter{
	pixel_y = 6;
	pixel_x = 11
	},
/obj/item/weapon/storage/fancy/cigarettes/goldencarp{
	pixel_y = 7;
	pixel_x = -6
	},
/turf/unsimulated/floor/jungle/path,
/area/surface/jungle)
"O" = (
/obj/effect/landmark/corpse,
/obj/structure/bed/chair/wood/normal,
/turf/unsimulated/floor/jungle/path,
/area/surface/jungle)
"R" = (
/obj/structure/flora/ausbushes/reedbush,
/turf/unsimulated/floor/jungle/grass,
/area/surface/jungle)

(1,1,1) = {"
a
t
t
p
t
"}
(2,1,1) = {"
t
h
c
t
p
"}
(3,1,1) = {"
t
y
O
y
t
"}
(4,1,1) = {"
R
t
G
t
t
"}
(5,1,1) = {"
R
R
t
u
u
"}
