//MAP CONVERTED BY dmm2tgm.py THIS HEADER COMMENT PREVENTS RECONVERSION, DO NOT REMOVE
"a" = (
/turf/unsimulated/floor/jungle/grass,
/area/surface/jungle)
"r" = (
/turf/unsimulated/floor/jungle/water,
/area/surface/jungle)

(1,1,1) = {"
a
a
a
a
a
a
a
a
a
"}
(2,1,1) = {"
a
r
a
a
a
a
a
a
a
"}
(3,1,1) = {"
a
r
a
a
a
a
a
a
a
"}
(4,1,1) = {"
a
r
r
r
r
r
r
r
a
"}
(5,1,1) = {"
a
r
a
a
a
a
a
a
a
"}
(6,1,1) = {"
a
r
a
a
a
a
a
a
a
"}
(7,1,1) = {"
a
a
a
a
a
a
a
a
a
"}
(8,1,1) = {"
a
a
a
a
a
a
a
a
a
"}
(9,1,1) = {"
a
r
r
r
r
r
r
r
a
"}
(10,1,1) = {"
a
r
a
a
r
a
a
r
a
"}
(11,1,1) = {"
a
r
a
a
r
a
a
r
a
"}
(12,1,1) = {"
a
r
a
a
r
a
a
r
a
"}
(13,1,1) = {"
a
r
a
a
r
a
a
r
a
"}
(14,1,1) = {"
a
a
a
a
a
a
a
a
a
"}
(15,1,1) = {"
a
a
a
a
a
a
a
a
a
"}
(16,1,1) = {"
a
a
r
r
a
a
r
a
a
"}
(17,1,1) = {"
a
r
a
a
r
a
a
r
a
"}
(18,1,1) = {"
a
r
a
a
r
a
a
r
a
"}
(19,1,1) = {"
a
r
a
a
r
a
a
r
a
"}
(20,1,1) = {"
a
a
r
a
a
r
r
a
a
"}
(21,1,1) = {"
a
a
a
a
a
a
a
a
a
"}
(22,1,1) = {"
a
a
a
a
a
a
a
a
a
"}
(23,1,1) = {"
a
r
a
a
a
a
a
a
a
"}
(24,1,1) = {"
a
r
a
a
a
a
a
a
a
"}
(25,1,1) = {"
a
r
r
r
r
r
r
r
a
"}
(26,1,1) = {"
a
r
a
a
a
a
a
a
a
"}
(27,1,1) = {"
a
r
a
a
a
a
a
a
a
"}
(28,1,1) = {"
a
a
a
a
a
a
a
a
a
"}
