//MAP CONVERTED BY dmm2tgm.py THIS HEADER COMMENT PREVENTS RECONVERSION, DO NOT REMOVE
"a" = (
/obj/effect/landmark/corpse/assistant,
/obj/item/weapon/reagent_containers/food/drinks/bottle,
/obj/structure/flora/ausbushes,
/turf/unsimulated/floor/jungle/grass,
/area/surface/jungle)
"e" = (
/obj/effect/decal/cleanable/vomit,
/turf/unsimulated/floor/jungle/grass,
/area/surface/jungle)
"i" = (
/obj/item/weapon/reagent_containers/food/drinks/bottle,
/obj/structure/flora/ausbushes,
/turf/unsimulated/floor/jungle/grass,
/area/surface/jungle)
"k" = (
/turf/unsimulated/floor/jungle/grass,
/area/surface/jungle)
"l" = (
/obj/structure/flora/ausbushes,
/turf/unsimulated/floor/jungle/grass,
/area/surface/jungle)
"o" = (
/obj/structure/flora/ausbushes/ppflowers,
/turf/unsimulated/floor/jungle/grass,
/area/surface/jungle)
"p" = (
/obj/item/weapon/storage/fancy/beer_box/empty,
/turf/unsimulated/floor/jungle/grass,
/area/surface/jungle)
"x" = (
/obj/structure/flora/tree/shitty,
/turf/unsimulated/floor/jungle/grass,
/area/surface/jungle)
"A" = (
/obj/item/weapon/reagent_containers/food/drinks/bottle,
/turf/unsimulated/floor/jungle/grass,
/area/surface/jungle)
"O" = (
/obj/structure/flora/ausbushes/sparsegrass,
/turf/unsimulated/floor/jungle/grass,
/area/surface/jungle)
"U" = (
/obj/structure/flora/ausbushes/grassybush,
/turf/unsimulated/floor/jungle/grass,
/area/surface/jungle)
"X" = (
/obj/item/weapon/reagent_containers/food/drinks/bottle,
/obj/structure/flora/ausbushes,
/obj/structure/flora/ausbushes,
/turf/unsimulated/floor/jungle/grass,
/area/surface/jungle)

(1,1,1) = {"
k
k
o
k
o
k
O
"}
(2,1,1) = {"
o
l
k
k
x
O
k
"}
(3,1,1) = {"
k
l
l
X
A
k
k
"}
(4,1,1) = {"
o
k
i
a
A
k
O
"}
(5,1,1) = {"
U
x
p
A
e
k
k
"}
(6,1,1) = {"
U
U
k
O
O
O
O
"}
(7,1,1) = {"
U
U
U
k
k
k
k
"}
