//MAP CONVERTED BY dmm2tgm.py THIS HEADER COMMENT PREVENTS RECONVERSION, DO NOT REMOVE
"cm" = (
/obj/docking_port/destination/odyssey/rendezvous_odyssey{
	dir = 2
	},
/turf/space,
/area)
"xY" = (
/obj/docking_port/destination/odyssey/rendezvous_trader,
/turf/space,
/area)
"zK" = (
/turf/space,
/area)

(1,1,1) = {"
zK
zK
zK
zK
zK
zK
zK
zK
zK
zK
zK
zK
zK
zK
zK
zK
zK
zK
zK
zK
zK
zK
zK
zK
zK
zK
zK
zK
zK
zK
zK
zK
zK
zK
zK
zK
zK
zK
zK
zK
zK
zK
zK
zK
zK
zK
zK
zK
zK
zK
zK
zK
zK
zK
zK
zK
zK
zK
zK
zK
zK
zK
zK
zK
zK
"}
(2,1,1) = {"
zK
zK
zK
zK
zK
zK
zK
zK
zK
zK
zK
zK
zK
zK
zK
zK
zK
zK
zK
zK
zK
zK
zK
zK
zK
zK
zK
zK
zK
zK
zK
zK
zK
zK
zK
zK
zK
zK
zK
zK
zK
zK
zK
zK
zK
zK
zK
zK
zK
zK
zK
zK
zK
zK
zK
zK
zK
zK
zK
zK
zK
zK
zK
zK
zK
"}
(3,1,1) = {"
zK
zK
zK
zK
zK
zK
zK
zK
zK
zK
zK
zK
zK
zK
zK
zK
zK
zK
zK
zK
zK
zK
zK
zK
zK
zK
zK
zK
zK
zK
zK
zK
zK
zK
zK
zK
zK
zK
zK
zK
zK
zK
zK
zK
zK
zK
zK
zK
zK
zK
zK
zK
zK
zK
zK
zK
zK
zK
zK
zK
zK
zK
zK
zK
zK
"}
(4,1,1) = {"
zK
zK
zK
zK
zK
zK
zK
zK
zK
zK
zK
zK
zK
zK
zK
zK
zK
zK
zK
zK
zK
zK
zK
zK
zK
zK
zK
zK
zK
zK
zK
zK
zK
zK
zK
zK
zK
zK
zK
zK
zK
zK
zK
zK
zK
zK
zK
zK
zK
zK
zK
zK
zK
zK
zK
zK
zK
zK
zK
zK
zK
zK
zK
zK
zK
"}
(5,1,1) = {"
zK
zK
zK
zK
zK
zK
zK
zK
zK
zK
zK
zK
zK
zK
zK
zK
zK
zK
zK
zK
zK
zK
zK
zK
zK
zK
zK
zK
zK
zK
zK
zK
zK
zK
zK
zK
zK
zK
zK
zK
zK
zK
zK
zK
zK
zK
zK
zK
zK
zK
zK
zK
zK
zK
zK
zK
zK
zK
zK
zK
zK
zK
zK
zK
zK
"}
(6,1,1) = {"
zK
zK
zK
zK
zK
zK
zK
zK
zK
zK
zK
zK
zK
zK
zK
zK
zK
zK
zK
zK
zK
zK
zK
zK
zK
zK
zK
zK
zK
zK
zK
zK
zK
zK
zK
zK
zK
zK
zK
zK
zK
zK
zK
zK
zK
zK
zK
zK
zK
zK
zK
zK
zK
zK
zK
zK
zK
zK
zK
zK
zK
zK
zK
zK
zK
"}
(7,1,1) = {"
zK
zK
zK
zK
zK
zK
zK
zK
zK
zK
zK
zK
zK
zK
zK
zK
zK
zK
zK
zK
zK
zK
zK
zK
zK
zK
zK
zK
zK
zK
zK
zK
zK
zK
zK
zK
zK
zK
zK
zK
zK
zK
zK
zK
zK
zK
zK
zK
zK
zK
zK
zK
zK
zK
zK
zK
zK
zK
zK
zK
zK
zK
zK
zK
zK
"}
(8,1,1) = {"
zK
zK
zK
zK
zK
zK
zK
zK
zK
zK
zK
zK
zK
zK
zK
zK
zK
zK
zK
zK
zK
zK
zK
zK
zK
zK
zK
zK
zK
zK
zK
zK
zK
zK
zK
zK
zK
zK
zK
zK
zK
zK
zK
zK
zK
zK
zK
zK
zK
zK
zK
zK
zK
zK
zK
zK
zK
zK
zK
zK
zK
zK
zK
zK
zK
"}
(9,1,1) = {"
zK
zK
zK
zK
zK
zK
zK
zK
zK
zK
zK
zK
zK
zK
zK
zK
zK
zK
zK
zK
zK
zK
zK
zK
zK
zK
zK
zK
zK
zK
zK
zK
zK
zK
zK
zK
zK
zK
zK
zK
zK
zK
zK
zK
zK
zK
zK
zK
zK
zK
zK
zK
zK
zK
zK
zK
zK
zK
zK
zK
zK
zK
zK
zK
zK
"}
(10,1,1) = {"
zK
zK
zK
zK
zK
zK
zK
zK
zK
zK
zK
zK
zK
zK
zK
zK
zK
zK
zK
zK
zK
zK
zK
zK
zK
zK
zK
zK
zK
zK
zK
zK
zK
zK
zK
zK
zK
zK
zK
zK
zK
zK
zK
zK
zK
zK
zK
zK
zK
zK
zK
zK
zK
zK
zK
zK
zK
zK
zK
zK
zK
zK
zK
zK
zK
"}
(11,1,1) = {"
zK
zK
zK
zK
zK
zK
zK
zK
zK
zK
zK
zK
zK
zK
zK
zK
zK
zK
zK
zK
zK
zK
zK
zK
zK
zK
zK
zK
zK
zK
zK
zK
zK
zK
zK
zK
zK
zK
zK
zK
zK
zK
zK
zK
zK
zK
zK
zK
zK
zK
zK
zK
zK
zK
zK
zK
zK
zK
zK
zK
zK
zK
zK
zK
zK
"}
(12,1,1) = {"
zK
zK
zK
zK
zK
zK
zK
zK
zK
zK
zK
zK
zK
zK
zK
zK
zK
zK
zK
zK
zK
zK
zK
zK
zK
zK
zK
zK
zK
zK
zK
zK
zK
zK
zK
zK
zK
zK
zK
zK
zK
zK
zK
zK
zK
zK
zK
zK
zK
zK
zK
zK
zK
zK
zK
zK
zK
zK
zK
zK
zK
zK
zK
zK
zK
"}
(13,1,1) = {"
zK
zK
zK
zK
zK
zK
zK
zK
zK
zK
zK
zK
zK
zK
zK
zK
zK
zK
zK
zK
zK
zK
zK
zK
zK
zK
zK
zK
zK
zK
zK
zK
zK
zK
zK
zK
zK
zK
zK
zK
zK
zK
zK
zK
zK
zK
zK
zK
zK
zK
zK
zK
zK
zK
zK
zK
zK
zK
zK
zK
zK
zK
zK
zK
zK
"}
(14,1,1) = {"
zK
zK
zK
zK
zK
zK
zK
zK
zK
zK
zK
zK
zK
zK
zK
zK
zK
zK
zK
zK
zK
zK
zK
zK
zK
zK
zK
zK
zK
zK
zK
zK
zK
zK
zK
zK
zK
zK
zK
zK
zK
zK
zK
zK
zK
zK
zK
zK
zK
zK
zK
zK
zK
zK
zK
zK
zK
zK
zK
zK
zK
zK
zK
zK
zK
"}
(15,1,1) = {"
zK
zK
zK
zK
zK
zK
zK
zK
zK
zK
zK
zK
zK
zK
zK
zK
zK
zK
zK
zK
zK
zK
zK
zK
zK
zK
zK
zK
zK
zK
zK
zK
zK
zK
zK
zK
zK
zK
zK
zK
zK
zK
zK
zK
zK
zK
zK
zK
zK
zK
zK
zK
zK
zK
zK
zK
zK
zK
zK
zK
zK
zK
zK
zK
zK
"}
(16,1,1) = {"
zK
zK
zK
zK
zK
zK
zK
zK
zK
zK
zK
zK
zK
zK
zK
zK
zK
zK
zK
zK
zK
zK
zK
zK
zK
zK
zK
zK
zK
zK
zK
zK
zK
zK
zK
zK
zK
zK
zK
zK
zK
zK
zK
zK
zK
zK
zK
zK
zK
zK
zK
zK
zK
zK
zK
zK
zK
zK
zK
zK
zK
zK
zK
zK
zK
"}
(17,1,1) = {"
zK
zK
zK
zK
zK
zK
zK
zK
zK
zK
zK
zK
zK
zK
zK
zK
zK
zK
zK
zK
zK
zK
zK
zK
zK
zK
zK
zK
zK
zK
zK
zK
zK
zK
zK
zK
zK
zK
zK
zK
zK
zK
zK
zK
zK
zK
zK
zK
zK
zK
zK
zK
zK
zK
zK
zK
zK
zK
zK
zK
zK
zK
zK
zK
zK
"}
(18,1,1) = {"
zK
zK
zK
zK
zK
zK
zK
zK
zK
zK
zK
zK
zK
zK
zK
zK
zK
zK
zK
zK
zK
zK
zK
zK
zK
zK
zK
zK
zK
zK
zK
zK
zK
zK
zK
zK
zK
zK
zK
zK
zK
zK
zK
zK
zK
zK
zK
zK
zK
zK
zK
zK
zK
zK
zK
zK
zK
zK
zK
zK
zK
zK
zK
zK
zK
"}
(19,1,1) = {"
zK
zK
zK
zK
zK
zK
zK
zK
zK
zK
zK
zK
zK
zK
zK
zK
zK
zK
zK
zK
zK
zK
zK
zK
zK
zK
zK
zK
zK
zK
zK
zK
zK
zK
zK
zK
zK
zK
zK
zK
zK
zK
zK
zK
zK
zK
zK
zK
zK
zK
zK
zK
zK
zK
zK
zK
zK
zK
zK
zK
zK
zK
zK
zK
zK
"}
(20,1,1) = {"
zK
zK
zK
zK
zK
zK
zK
zK
zK
zK
zK
zK
zK
zK
zK
zK
zK
zK
zK
zK
zK
zK
zK
zK
zK
zK
zK
zK
zK
zK
zK
zK
zK
zK
zK
zK
zK
zK
zK
zK
zK
zK
zK
zK
zK
zK
zK
zK
zK
zK
zK
zK
zK
zK
zK
zK
zK
zK
zK
zK
zK
zK
zK
zK
zK
"}
(21,1,1) = {"
zK
zK
zK
zK
zK
zK
zK
zK
zK
zK
zK
zK
zK
zK
zK
zK
zK
zK
zK
zK
zK
zK
zK
zK
zK
zK
zK
zK
zK
zK
zK
zK
zK
zK
zK
zK
zK
zK
zK
zK
zK
zK
zK
zK
zK
zK
zK
zK
zK
zK
zK
zK
zK
zK
zK
zK
zK
zK
zK
zK
zK
zK
zK
zK
zK
"}
(22,1,1) = {"
zK
zK
zK
zK
zK
zK
zK
zK
zK
zK
zK
zK
zK
zK
zK
zK
zK
zK
zK
zK
zK
zK
zK
zK
zK
zK
zK
zK
zK
zK
zK
zK
zK
zK
zK
zK
zK
zK
zK
zK
zK
zK
zK
zK
zK
zK
zK
zK
zK
zK
zK
zK
zK
zK
zK
zK
zK
zK
zK
zK
zK
zK
zK
zK
zK
"}
(23,1,1) = {"
zK
zK
zK
zK
zK
zK
zK
zK
zK
zK
zK
zK
zK
zK
zK
zK
zK
zK
zK
zK
zK
zK
zK
zK
zK
zK
zK
zK
zK
zK
zK
zK
zK
zK
zK
zK
zK
zK
zK
zK
zK
zK
zK
zK
zK
zK
zK
zK
zK
zK
zK
zK
zK
zK
zK
zK
zK
zK
zK
zK
zK
zK
zK
zK
zK
"}
(24,1,1) = {"
zK
zK
zK
zK
zK
zK
zK
zK
zK
zK
zK
zK
zK
zK
zK
zK
zK
zK
zK
zK
zK
zK
zK
zK
zK
zK
zK
zK
zK
zK
zK
zK
zK
zK
zK
zK
zK
zK
zK
zK
zK
zK
zK
zK
zK
zK
zK
zK
zK
zK
zK
zK
zK
zK
zK
zK
zK
zK
zK
zK
zK
zK
zK
zK
zK
"}
(25,1,1) = {"
zK
zK
zK
zK
zK
zK
zK
zK
zK
zK
zK
zK
zK
zK
zK
zK
zK
zK
zK
zK
zK
zK
zK
zK
zK
zK
zK
zK
zK
zK
zK
zK
zK
zK
zK
zK
zK
zK
zK
zK
zK
zK
zK
zK
zK
zK
zK
zK
zK
zK
zK
zK
zK
zK
zK
zK
zK
zK
zK
zK
zK
zK
zK
zK
zK
"}
(26,1,1) = {"
zK
zK
zK
zK
zK
zK
zK
zK
zK
zK
zK
zK
zK
zK
zK
zK
zK
zK
zK
zK
zK
zK
zK
xY
zK
zK
zK
zK
zK
zK
zK
zK
zK
zK
zK
zK
zK
zK
zK
zK
zK
zK
zK
zK
zK
zK
zK
zK
zK
zK
zK
zK
zK
zK
zK
zK
zK
zK
zK
zK
zK
zK
zK
zK
zK
"}
(27,1,1) = {"
zK
zK
zK
zK
zK
zK
zK
zK
zK
zK
zK
zK
zK
zK
zK
zK
zK
zK
zK
zK
zK
zK
cm
zK
zK
zK
zK
zK
zK
zK
zK
zK
zK
zK
zK
zK
zK
zK
zK
zK
zK
zK
zK
zK
zK
zK
zK
zK
zK
zK
zK
zK
zK
zK
zK
zK
zK
zK
zK
zK
zK
zK
zK
zK
zK
"}
(28,1,1) = {"
zK
zK
zK
zK
zK
zK
zK
zK
zK
zK
zK
zK
zK
zK
zK
zK
zK
zK
zK
zK
zK
zK
zK
zK
zK
zK
zK
zK
zK
zK
zK
zK
zK
zK
zK
zK
zK
zK
zK
zK
zK
zK
zK
zK
zK
zK
zK
zK
zK
zK
zK
zK
zK
zK
zK
zK
zK
zK
zK
zK
zK
zK
zK
zK
zK
"}
(29,1,1) = {"
zK
zK
zK
zK
zK
zK
zK
zK
zK
zK
zK
zK
zK
zK
zK
zK
zK
zK
zK
zK
zK
zK
zK
zK
zK
zK
zK
zK
zK
zK
zK
zK
zK
zK
zK
zK
zK
zK
zK
zK
zK
zK
zK
zK
zK
zK
zK
zK
zK
zK
zK
zK
zK
zK
zK
zK
zK
zK
zK
zK
zK
zK
zK
zK
zK
"}
(30,1,1) = {"
zK
zK
zK
zK
zK
zK
zK
zK
zK
zK
zK
zK
zK
zK
zK
zK
zK
zK
zK
zK
zK
zK
zK
zK
zK
zK
zK
zK
zK
zK
zK
zK
zK
zK
zK
zK
zK
zK
zK
zK
zK
zK
zK
zK
zK
zK
zK
zK
zK
zK
zK
zK
zK
zK
zK
zK
zK
zK
zK
zK
zK
zK
zK
zK
zK
"}
(31,1,1) = {"
zK
zK
zK
zK
zK
zK
zK
zK
zK
zK
zK
zK
zK
zK
zK
zK
zK
zK
zK
zK
zK
zK
zK
zK
zK
zK
zK
zK
zK
zK
zK
zK
zK
zK
zK
zK
zK
zK
zK
zK
zK
zK
zK
zK
zK
zK
zK
zK
zK
zK
zK
zK
zK
zK
zK
zK
zK
zK
zK
zK
zK
zK
zK
zK
zK
"}
(32,1,1) = {"
zK
zK
zK
zK
zK
zK
zK
zK
zK
zK
zK
zK
zK
zK
zK
zK
zK
zK
zK
zK
zK
zK
zK
zK
zK
zK
zK
zK
zK
zK
zK
zK
zK
zK
zK
zK
zK
zK
zK
zK
zK
zK
zK
zK
zK
zK
zK
zK
zK
zK
zK
zK
zK
zK
zK
zK
zK
zK
zK
zK
zK
zK
zK
zK
zK
"}
(33,1,1) = {"
zK
zK
zK
zK
zK
zK
zK
zK
zK
zK
zK
zK
zK
zK
zK
zK
zK
zK
zK
zK
zK
zK
zK
zK
zK
zK
zK
zK
zK
zK
zK
zK
zK
zK
zK
zK
zK
zK
zK
zK
zK
zK
zK
zK
zK
zK
zK
zK
zK
zK
zK
zK
zK
zK
zK
zK
zK
zK
zK
zK
zK
zK
zK
zK
zK
"}
(34,1,1) = {"
zK
zK
zK
zK
zK
zK
zK
zK
zK
zK
zK
zK
zK
zK
zK
zK
zK
zK
zK
zK
zK
zK
zK
zK
zK
zK
zK
zK
zK
zK
zK
zK
zK
zK
zK
zK
zK
zK
zK
zK
zK
zK
zK
zK
zK
zK
zK
zK
zK
zK
zK
zK
zK
zK
zK
zK
zK
zK
zK
zK
zK
zK
zK
zK
zK
"}
(35,1,1) = {"
zK
zK
zK
zK
zK
zK
zK
zK
zK
zK
zK
zK
zK
zK
zK
zK
zK
zK
zK
zK
zK
zK
zK
zK
zK
zK
zK
zK
zK
zK
zK
zK
zK
zK
zK
zK
zK
zK
zK
zK
zK
zK
zK
zK
zK
zK
zK
zK
zK
zK
zK
zK
zK
zK
zK
zK
zK
zK
zK
zK
zK
zK
zK
zK
zK
"}
(36,1,1) = {"
zK
zK
zK
zK
zK
zK
zK
zK
zK
zK
zK
zK
zK
zK
zK
zK
zK
zK
zK
zK
zK
zK
zK
zK
zK
zK
zK
zK
zK
zK
zK
zK
zK
zK
zK
zK
zK
zK
zK
zK
zK
zK
zK
zK
zK
zK
zK
zK
zK
zK
zK
zK
zK
zK
zK
zK
zK
zK
zK
zK
zK
zK
zK
zK
zK
"}
(37,1,1) = {"
zK
zK
zK
zK
zK
zK
zK
zK
zK
zK
zK
zK
zK
zK
zK
zK
zK
zK
zK
zK
zK
zK
zK
zK
zK
zK
zK
zK
zK
zK
zK
zK
zK
zK
zK
zK
zK
zK
zK
zK
zK
zK
zK
zK
zK
zK
zK
zK
zK
zK
zK
zK
zK
zK
zK
zK
zK
zK
zK
zK
zK
zK
zK
zK
zK
"}
(38,1,1) = {"
zK
zK
zK
zK
zK
zK
zK
zK
zK
zK
zK
zK
zK
zK
zK
zK
zK
zK
zK
zK
zK
zK
zK
zK
zK
zK
zK
zK
zK
zK
zK
zK
zK
zK
zK
zK
zK
zK
zK
zK
zK
zK
zK
zK
zK
zK
zK
zK
zK
zK
zK
zK
zK
zK
zK
zK
zK
zK
zK
zK
zK
zK
zK
zK
zK
"}
(39,1,1) = {"
zK
zK
zK
zK
zK
zK
zK
zK
zK
zK
zK
zK
zK
zK
zK
zK
zK
zK
zK
zK
zK
zK
zK
zK
zK
zK
zK
zK
zK
zK
zK
zK
zK
zK
zK
zK
zK
zK
zK
zK
zK
zK
zK
zK
zK
zK
zK
zK
zK
zK
zK
zK
zK
zK
zK
zK
zK
zK
zK
zK
zK
zK
zK
zK
zK
"}
(40,1,1) = {"
zK
zK
zK
zK
zK
zK
zK
zK
zK
zK
zK
zK
zK
zK
zK
zK
zK
zK
zK
zK
zK
zK
zK
zK
zK
zK
zK
zK
zK
zK
zK
zK
zK
zK
zK
zK
zK
zK
zK
zK
zK
zK
zK
zK
zK
zK
zK
zK
zK
zK
zK
zK
zK
zK
zK
zK
zK
zK
zK
zK
zK
zK
zK
zK
zK
"}
(41,1,1) = {"
zK
zK
zK
zK
zK
zK
zK
zK
zK
zK
zK
zK
zK
zK
zK
zK
zK
zK
zK
zK
zK
zK
zK
zK
zK
zK
zK
zK
zK
zK
zK
zK
zK
zK
zK
zK
zK
zK
zK
zK
zK
zK
zK
zK
zK
zK
zK
zK
zK
zK
zK
zK
zK
zK
zK
zK
zK
zK
zK
zK
zK
zK
zK
zK
zK
"}
(42,1,1) = {"
zK
zK
zK
zK
zK
zK
zK
zK
zK
zK
zK
zK
zK
zK
zK
zK
zK
zK
zK
zK
zK
zK
zK
zK
zK
zK
zK
zK
zK
zK
zK
zK
zK
zK
zK
zK
zK
zK
zK
zK
zK
zK
zK
zK
zK
zK
zK
zK
zK
zK
zK
zK
zK
zK
zK
zK
zK
zK
zK
zK
zK
zK
zK
zK
zK
"}
(43,1,1) = {"
zK
zK
zK
zK
zK
zK
zK
zK
zK
zK
zK
zK
zK
zK
zK
zK
zK
zK
zK
zK
zK
zK
zK
zK
zK
zK
zK
zK
zK
zK
zK
zK
zK
zK
zK
zK
zK
zK
zK
zK
zK
zK
zK
zK
zK
zK
zK
zK
zK
zK
zK
zK
zK
zK
zK
zK
zK
zK
zK
zK
zK
zK
zK
zK
zK
"}
(44,1,1) = {"
zK
zK
zK
zK
zK
zK
zK
zK
zK
zK
zK
zK
zK
zK
zK
zK
zK
zK
zK
zK
zK
zK
zK
zK
zK
zK
zK
zK
zK
zK
zK
zK
zK
zK
zK
zK
zK
zK
zK
zK
zK
zK
zK
zK
zK
zK
zK
zK
zK
zK
zK
zK
zK
zK
zK
zK
zK
zK
zK
zK
zK
zK
zK
zK
zK
"}
(45,1,1) = {"
zK
zK
zK
zK
zK
zK
zK
zK
zK
zK
zK
zK
zK
zK
zK
zK
zK
zK
zK
zK
zK
zK
zK
zK
zK
zK
zK
zK
zK
zK
zK
zK
zK
zK
zK
zK
zK
zK
zK
zK
zK
zK
zK
zK
zK
zK
zK
zK
zK
zK
zK
zK
zK
zK
zK
zK
zK
zK
zK
zK
zK
zK
zK
zK
zK
"}
(46,1,1) = {"
zK
zK
zK
zK
zK
zK
zK
zK
zK
zK
zK
zK
zK
zK
zK
zK
zK
zK
zK
zK
zK
zK
zK
zK
zK
zK
zK
zK
zK
zK
zK
zK
zK
zK
zK
zK
zK
zK
zK
zK
zK
zK
zK
zK
zK
zK
zK
zK
zK
zK
zK
zK
zK
zK
zK
zK
zK
zK
zK
zK
zK
zK
zK
zK
zK
"}
(47,1,1) = {"
zK
zK
zK
zK
zK
zK
zK
zK
zK
zK
zK
zK
zK
zK
zK
zK
zK
zK
zK
zK
zK
zK
zK
zK
zK
zK
zK
zK
zK
zK
zK
zK
zK
zK
zK
zK
zK
zK
zK
zK
zK
zK
zK
zK
zK
zK
zK
zK
zK
zK
zK
zK
zK
zK
zK
zK
zK
zK
zK
zK
zK
zK
zK
zK
zK
"}
(48,1,1) = {"
zK
zK
zK
zK
zK
zK
zK
zK
zK
zK
zK
zK
zK
zK
zK
zK
zK
zK
zK
zK
zK
zK
zK
zK
zK
zK
zK
zK
zK
zK
zK
zK
zK
zK
zK
zK
zK
zK
zK
zK
zK
zK
zK
zK
zK
zK
zK
zK
zK
zK
zK
zK
zK
zK
zK
zK
zK
zK
zK
zK
zK
zK
zK
zK
zK
"}
(49,1,1) = {"
zK
zK
zK
zK
zK
zK
zK
zK
zK
zK
zK
zK
zK
zK
zK
zK
zK
zK
zK
zK
zK
zK
zK
zK
zK
zK
zK
zK
zK
zK
zK
zK
zK
zK
zK
zK
zK
zK
zK
zK
zK
zK
zK
zK
zK
zK
zK
zK
zK
zK
zK
zK
zK
zK
zK
zK
zK
zK
zK
zK
zK
zK
zK
zK
zK
"}
(50,1,1) = {"
zK
zK
zK
zK
zK
zK
zK
zK
zK
zK
zK
zK
zK
zK
zK
zK
zK
zK
zK
zK
zK
zK
zK
zK
zK
zK
zK
zK
zK
zK
zK
zK
zK
zK
zK
zK
zK
zK
zK
zK
zK
zK
zK
zK
zK
zK
zK
zK
zK
zK
zK
zK
zK
zK
zK
zK
zK
zK
zK
zK
zK
zK
zK
zK
zK
"}
(51,1,1) = {"
zK
zK
zK
zK
zK
zK
zK
zK
zK
zK
zK
zK
zK
zK
zK
zK
zK
zK
zK
zK
zK
zK
zK
zK
zK
zK
zK
zK
zK
zK
zK
zK
zK
zK
zK
zK
zK
zK
zK
zK
zK
zK
zK
zK
zK
zK
zK
zK
zK
zK
zK
zK
zK
zK
zK
zK
zK
zK
zK
zK
zK
zK
zK
zK
zK
"}
(52,1,1) = {"
zK
zK
zK
zK
zK
zK
zK
zK
zK
zK
zK
zK
zK
zK
zK
zK
zK
zK
zK
zK
zK
zK
zK
zK
zK
zK
zK
zK
zK
zK
zK
zK
zK
zK
zK
zK
zK
zK
zK
zK
zK
zK
zK
zK
zK
zK
zK
zK
zK
zK
zK
zK
zK
zK
zK
zK
zK
zK
zK
zK
zK
zK
zK
zK
zK
"}
(53,1,1) = {"
zK
zK
zK
zK
zK
zK
zK
zK
zK
zK
zK
zK
zK
zK
zK
zK
zK
zK
zK
zK
zK
zK
zK
zK
zK
zK
zK
zK
zK
zK
zK
zK
zK
zK
zK
zK
zK
zK
zK
zK
zK
zK
zK
zK
zK
zK
zK
zK
zK
zK
zK
zK
zK
zK
zK
zK
zK
zK
zK
zK
zK
zK
zK
zK
zK
"}
(54,1,1) = {"
zK
zK
zK
zK
zK
zK
zK
zK
zK
zK
zK
zK
zK
zK
zK
zK
zK
zK
zK
zK
zK
zK
zK
zK
zK
zK
zK
zK
zK
zK
zK
zK
zK
zK
zK
zK
zK
zK
zK
zK
zK
zK
zK
zK
zK
zK
zK
zK
zK
zK
zK
zK
zK
zK
zK
zK
zK
zK
zK
zK
zK
zK
zK
zK
zK
"}
(55,1,1) = {"
zK
zK
zK
zK
zK
zK
zK
zK
zK
zK
zK
zK
zK
zK
zK
zK
zK
zK
zK
zK
zK
zK
zK
zK
zK
zK
zK
zK
zK
zK
zK
zK
zK
zK
zK
zK
zK
zK
zK
zK
zK
zK
zK
zK
zK
zK
zK
zK
zK
zK
zK
zK
zK
zK
zK
zK
zK
zK
zK
zK
zK
zK
zK
zK
zK
"}
(56,1,1) = {"
zK
zK
zK
zK
zK
zK
zK
zK
zK
zK
zK
zK
zK
zK
zK
zK
zK
zK
zK
zK
zK
zK
zK
zK
zK
zK
zK
zK
zK
zK
zK
zK
zK
zK
zK
zK
zK
zK
zK
zK
zK
zK
zK
zK
zK
zK
zK
zK
zK
zK
zK
zK
zK
zK
zK
zK
zK
zK
zK
zK
zK
zK
zK
zK
zK
"}
(57,1,1) = {"
zK
zK
zK
zK
zK
zK
zK
zK
zK
zK
zK
zK
zK
zK
zK
zK
zK
zK
zK
zK
zK
zK
zK
zK
zK
zK
zK
zK
zK
zK
zK
zK
zK
zK
zK
zK
zK
zK
zK
zK
zK
zK
zK
zK
zK
zK
zK
zK
zK
zK
zK
zK
zK
zK
zK
zK
zK
zK
zK
zK
zK
zK
zK
zK
zK
"}
(58,1,1) = {"
zK
zK
zK
zK
zK
zK
zK
zK
zK
zK
zK
zK
zK
zK
zK
zK
zK
zK
zK
zK
zK
zK
zK
zK
zK
zK
zK
zK
zK
zK
zK
zK
zK
zK
zK
zK
zK
zK
zK
zK
zK
zK
zK
zK
zK
zK
zK
zK
zK
zK
zK
zK
zK
zK
zK
zK
zK
zK
zK
zK
zK
zK
zK
zK
zK
"}
(59,1,1) = {"
zK
zK
zK
zK
zK
zK
zK
zK
zK
zK
zK
zK
zK
zK
zK
zK
zK
zK
zK
zK
zK
zK
zK
zK
zK
zK
zK
zK
zK
zK
zK
zK
zK
zK
zK
zK
zK
zK
zK
zK
zK
zK
zK
zK
zK
zK
zK
zK
zK
zK
zK
zK
zK
zK
zK
zK
zK
zK
zK
zK
zK
zK
zK
zK
zK
"}
(60,1,1) = {"
zK
zK
zK
zK
zK
zK
zK
zK
zK
zK
zK
zK
zK
zK
zK
zK
zK
zK
zK
zK
zK
zK
zK
zK
zK
zK
zK
zK
zK
zK
zK
zK
zK
zK
zK
zK
zK
zK
zK
zK
zK
zK
zK
zK
zK
zK
zK
zK
zK
zK
zK
zK
zK
zK
zK
zK
zK
zK
zK
zK
zK
zK
zK
zK
zK
"}
(61,1,1) = {"
zK
zK
zK
zK
zK
zK
zK
zK
zK
zK
zK
zK
zK
zK
zK
zK
zK
zK
zK
zK
zK
zK
zK
zK
zK
zK
zK
zK
zK
zK
zK
zK
zK
zK
zK
zK
zK
zK
zK
zK
zK
zK
zK
zK
zK
zK
zK
zK
zK
zK
zK
zK
zK
zK
zK
zK
zK
zK
zK
zK
zK
zK
zK
zK
zK
"}
(62,1,1) = {"
zK
zK
zK
zK
zK
zK
zK
zK
zK
zK
zK
zK
zK
zK
zK
zK
zK
zK
zK
zK
zK
zK
zK
zK
zK
zK
zK
zK
zK
zK
zK
zK
zK
zK
zK
zK
zK
zK
zK
zK
zK
zK
zK
zK
zK
zK
zK
zK
zK
zK
zK
zK
zK
zK
zK
zK
zK
zK
zK
zK
zK
zK
zK
zK
zK
"}
(63,1,1) = {"
zK
zK
zK
zK
zK
zK
zK
zK
zK
zK
zK
zK
zK
zK
zK
zK
zK
zK
zK
zK
zK
zK
zK
zK
zK
zK
zK
zK
zK
zK
zK
zK
zK
zK
zK
zK
zK
zK
zK
zK
zK
zK
zK
zK
zK
zK
zK
zK
zK
zK
zK
zK
zK
zK
zK
zK
zK
zK
zK
zK
zK
zK
zK
zK
zK
"}
(64,1,1) = {"
zK
zK
zK
zK
zK
zK
zK
zK
zK
zK
zK
zK
zK
zK
zK
zK
zK
zK
zK
zK
zK
zK
zK
zK
zK
zK
zK
zK
zK
zK
zK
zK
zK
zK
zK
zK
zK
zK
zK
zK
zK
zK
zK
zK
zK
zK
zK
zK
zK
zK
zK
zK
zK
zK
zK
zK
zK
zK
zK
zK
zK
zK
zK
zK
zK
"}
(65,1,1) = {"
zK
zK
zK
zK
zK
zK
zK
zK
zK
zK
zK
zK
zK
zK
zK
zK
zK
zK
zK
zK
zK
zK
zK
zK
zK
zK
zK
zK
zK
zK
zK
zK
zK
zK
zK
zK
zK
zK
zK
zK
zK
zK
zK
zK
zK
zK
zK
zK
zK
zK
zK
zK
zK
zK
zK
zK
zK
zK
zK
zK
zK
zK
zK
zK
zK
"}
(66,1,1) = {"
zK
zK
zK
zK
zK
zK
zK
zK
zK
zK
zK
zK
zK
zK
zK
zK
zK
zK
zK
zK
zK
zK
zK
zK
zK
zK
zK
zK
zK
zK
zK
zK
zK
zK
zK
zK
zK
zK
zK
zK
zK
zK
zK
zK
zK
zK
zK
zK
zK
zK
zK
zK
zK
zK
zK
zK
zK
zK
zK
zK
zK
zK
zK
zK
zK
"}
(67,1,1) = {"
zK
zK
zK
zK
zK
zK
zK
zK
zK
zK
zK
zK
zK
zK
zK
zK
zK
zK
zK
zK
zK
zK
zK
zK
zK
zK
zK
zK
zK
zK
zK
zK
zK
zK
zK
zK
zK
zK
zK
zK
zK
zK
zK
zK
zK
zK
zK
zK
zK
zK
zK
zK
zK
zK
zK
zK
zK
zK
zK
zK
zK
zK
zK
zK
zK
"}
(68,1,1) = {"
zK
zK
zK
zK
zK
zK
zK
zK
zK
zK
zK
zK
zK
zK
zK
zK
zK
zK
zK
zK
zK
zK
zK
zK
zK
zK
zK
zK
zK
zK
zK
zK
zK
zK
zK
zK
zK
zK
zK
zK
zK
zK
zK
zK
zK
zK
zK
zK
zK
zK
zK
zK
zK
zK
zK
zK
zK
zK
zK
zK
zK
zK
zK
zK
zK
"}
(69,1,1) = {"
zK
zK
zK
zK
zK
zK
zK
zK
zK
zK
zK
zK
zK
zK
zK
zK
zK
zK
zK
zK
zK
zK
zK
zK
zK
zK
zK
zK
zK
zK
zK
zK
zK
zK
zK
zK
zK
zK
zK
zK
zK
zK
zK
zK
zK
zK
zK
zK
zK
zK
zK
zK
zK
zK
zK
zK
zK
zK
zK
zK
zK
zK
zK
zK
zK
"}
(70,1,1) = {"
zK
zK
zK
zK
zK
zK
zK
zK
zK
zK
zK
zK
zK
zK
zK
zK
zK
zK
zK
zK
zK
zK
zK
zK
zK
zK
zK
zK
zK
zK
zK
zK
zK
zK
zK
zK
zK
zK
zK
zK
zK
zK
zK
zK
zK
zK
zK
zK
zK
zK
zK
zK
zK
zK
zK
zK
zK
zK
zK
zK
zK
zK
zK
zK
zK
"}
(71,1,1) = {"
zK
zK
zK
zK
zK
zK
zK
zK
zK
zK
zK
zK
zK
zK
zK
zK
zK
zK
zK
zK
zK
zK
zK
zK
zK
zK
zK
zK
zK
zK
zK
zK
zK
zK
zK
zK
zK
zK
zK
zK
zK
zK
zK
zK
zK
zK
zK
zK
zK
zK
zK
zK
zK
zK
zK
zK
zK
zK
zK
zK
zK
zK
zK
zK
zK
"}
