//MAP CONVERTED BY dmm2tgm.py THIS HEADER COMMENT PREVENTS RECONVERSION, DO NOT REMOVE
"a" = (
/turf/unsimulated/floor/planetary/dirt,
/area/exposed_ruin)
"e" = (
/obj/structure/closet/cabinet,
/obj/item/clothing/head/wizard/clown,
/obj/item/clothing/suit/wizrobe/marisa,
/turf/simulated/floor/wood,
/area/ruin)
"f" = (
/obj/structure/bed/chair/wood/normal{
	dir = 4
	},
/turf/simulated/floor/wood,
/area/ruin)
"h" = (
/turf/simulated/floor/wood,
/area/ruin)
"j" = (
/turf/template_noop,
/area/template_noop)
"k" = (
/obj/structure/grille,
/obj/structure/window{
	dir = 4
	},
/obj/structure/window{
	dir = 8
	},
/turf/simulated/floor/plating/deck,
/area/ruin)
"l" = (
/obj/effect/decal/cleanable/campfire,
/obj/structure/reagent_dispensers/cauldron{
	name = "Witch's cauldron"
	},
/turf/unsimulated/floor/planetary/dirt,
/area/exposed_ruin)
"q" = (
/obj/structure/grille,
/obj/structure/window{
	dir = 4
	},
/obj/structure/window{
	dir = 8
	},
/obj/structure/window,
/turf/simulated/floor/plating/deck,
/area/ruin)
"t" = (
/turf/simulated/wall/mineral/wood,
/area/ruin)
"y" = (
/obj/structure/bed,
/obj/item/weapon/bedsheet/purple,
/turf/simulated/floor/wood,
/area/ruin)
"z" = (
/obj/structure/grille,
/obj/structure/window{
	dir = 4
	},
/obj/structure/window{
	dir = 8
	},
/obj/structure/window{
	dir = 1
	},
/turf/simulated/floor/plating/deck,
/area/ruin)
"D" = (
/obj/structure/table/woodentable,
/obj/item/weapon/reagent_containers/glass/mortar,
/obj/item/weapon/reagent_containers/food/drinks/drinkingglass{
	pixel_y = 7;
	pixel_x = 2
	},
/obj/item/weapon/reagent_containers/food/drinks/drinkingglass{
	pixel_y = 4;
	pixel_x = -8
	},
/obj/item/weapon/reagent_containers/food/drinks/drinkingglass{
	pixel_y = 8;
	pixel_x = 11
	},
/turf/simulated/floor/wood,
/area/ruin)
"J" = (
/obj/structure/table/woodentable,
/obj/item/potion/fullness,
/obj/item/potion/paralysis{
	pixel_y = 11;
	pixel_x = 10
	},
/obj/item/potion/speed{
	pixel_y = 10;
	pixel_x = -6
	},
/turf/simulated/floor/wood,
/area/ruin)
"N" = (
/mob/living/complex_animal/frog/poison,
/turf/template_noop,
/area/template_noop)
"O" = (
/obj/machinery/door/mineral/wood{
	name = "Wooden Door"
	},
/turf/simulated/floor/plating/deck,
/area/ruin)
"U" = (
/obj/structure/table/woodentable,
/obj/item/weapon/reagent_containers/food/snacks/grown/berries/jungle,
/obj/item/weapon/reagent_containers/food/snacks/grown/berries/jungle{
	pixel_x = 5
	},
/obj/item/weapon/reagent_containers/food/snacks/grown/berries/jungle{
	pixel_x = -4
	},
/obj/item/weapon/reagent_containers/food/snacks/grown/berries/jungle{
	pixel_x = -6;
	pixel_y = 10
	},
/obj/item/weapon/reagent_containers/food/snacks/grown/berries/jungle{
	pixel_x = 6;
	pixel_y = 7
	},
/turf/simulated/floor/wood,
/area/ruin)
"W" = (
/mob/living/complex_animal/frog,
/turf/template_noop,
/area/template_noop)

(1,1,1) = {"
j
j
j
W
j
N
j
j
N
j
"}
(2,1,1) = {"
N
j
t
t
t
t
t
W
j
N
"}
(3,1,1) = {"
j
j
t
y
h
e
t
j
j
j
"}
(4,1,1) = {"
j
j
t
f
h
h
O
a
j
j
"}
(5,1,1) = {"
j
j
t
D
U
J
t
a
j
W
"}
(6,1,1) = {"
W
j
t
z
k
q
t
a
j
j
"}
(7,1,1) = {"
j
j
j
j
a
a
a
a
j
j
"}
(8,1,1) = {"
j
j
j
a
l
a
a
a
j
j
"}
(9,1,1) = {"
j
j
W
j
a
j
W
j
j
W
"}
(10,1,1) = {"
j
N
j
j
j
j
j
j
N
j
"}
(11,1,1) = {"
j
j
j
j
j
j
j
j
j
j
"}
