//MAP CONVERTED BY dmm2tgm.py THIS HEADER COMMENT PREVENTS RECONVERSION, DO NOT REMOVE
"a" = (
/turf/template_noop,
/area/template_noop)
"b" = (
/obj/structure/grille,
/obj/structure/window{
	dir = 1
	},
/obj/structure/window{
	dir = 8
	},
/obj/structure/window{
	dir = 4
	},
/turf/simulated/floor/plating/deck,
/area/ruin)
"d" = (
/obj/machinery/door/mineral/wood,
/turf/simulated/floor/wood,
/area/ruin)
"e" = (
/obj/structure/table/woodentable,
/obj/item/weapon/reagent_containers/food/drinks/drinkingglass,
/obj/item/weapon/reagent_containers/food/drinks/drinkingglass,
/obj/item/weapon/reagent_containers/food/drinks/drinkingglass,
/obj/item/weapon/reagent_containers/food/drinks/drinkingglass,
/obj/item/weapon/reagent_containers/food/drinks/drinkingglass,
/turf/simulated/floor/wood,
/area/ruin)
"l" = (
/obj/item/weapon/stool/bar,
/turf/template_noop,
/area/exposed_ruin)
"n" = (
/obj/structure/table/woodentable,
/obj/item/weapon/reagent_containers/food/drinks/soda_cans/gunka_cola{
	pixel_x = -7
	},
/obj/item/weapon/reagent_containers/food/drinks/soda_cans/gunka_cola{
	pixel_y = 6;
	pixel_x = 9
	},
/obj/item/weapon/reagent_containers/food/snacks/grown/berries/jungle,
/obj/item/weapon/reagent_containers/food/snacks/grown/berries/jungle,
/obj/abstract/loot_spawner/food_or_drink,
/turf/simulated/floor/wood,
/area/ruin)
"q" = (
/obj/structure/table/woodentable,
/obj/item/weapon/reagent_containers/food/drinks/bottle/vodka{
	pixel_x = -6
	},
/obj/item/weapon/reagent_containers/food/drinks/bottle/limejuice{
	pixel_x = 7
	},
/turf/simulated/floor/wood,
/area/ruin)
"t" = (
/mob/living/complex_animal/parrot{
	builtin_phrases = list("Hi.","Hello!","Cracker?","BAWWWWK george mellons griffing me!","Give me a drink, bartender.","Another round!","What the hell am I drinking?","And stay out!","No tabs - cash up front!");
	name = "Mallory";
	mob_max_age = 45000;
	food_per_tick = 0.0
	},
/turf/simulated/floor/wood,
/area/ruin)
"u" = (
/obj/structure/table/woodentable,
/obj/item/weapon/reagent_containers/food/drinks/bottle/tequila{
	pixel_x = 4
	},
/obj/item/weapon/reagent_containers/food/drinks/bottle/rum{
	pixel_x = -9
	},
/turf/simulated/floor/wood,
/area/ruin)
"v" = (
/obj/structure/table/woodentable,
/turf/simulated/floor/wood,
/area/ruin)
"w" = (
/turf/simulated/floor/wood,
/area/ruin)
"A" = (
/obj/structure/table/woodentable,
/obj/item/weapon/reagent_containers/food/drinks/drinkingglass,
/obj/item/weapon/reagent_containers/food/drinks/drinkingglass,
/obj/item/weapon/reagent_containers/food/drinks/drinkingglass,
/obj/item/weapon/reagent_containers/food/drinks/drinkingglass,
/obj/item/weapon/reagent_containers/food/drinks/drinkingglass,
/obj/abstract/loot_spawner/food_or_drink,
/turf/simulated/floor/wood,
/area/ruin)
"E" = (
/obj/structure/closet/crate/freezer,
/obj/item/ice_crystal,
/obj/item/ice_crystal,
/obj/item/ice_crystal,
/obj/item/ice_crystal,
/obj/item/ice_crystal,
/obj/item/ice_crystal,
/obj/item/ice_crystal,
/turf/simulated/floor/wood,
/area/ruin)
"F" = (
/obj/structure/table/woodentable,
/obj/item/weapon/spacecash/c10,
/obj/item/weapon/spacecash/c10,
/obj/item/weapon/spacecash/c10,
/turf/simulated/floor/wood,
/area/ruin)
"L" = (
/turf/simulated/wall/mineral/wood,
/area/ruin)
"Q" = (
/obj/structure/grille,
/obj/structure/window{
	dir = 8
	},
/obj/structure/window{
	dir = 4
	},
/obj/structure/window,
/turf/simulated/floor/plating/deck,
/area/ruin)
"U" = (
/obj/structure/hanging_lantern/dim,
/turf/simulated/floor/wood,
/area/ruin)
"V" = (
/turf/template_noop,
/area/exposed_ruin)
"Y" = (
/obj/structure/table/woodentable,
/obj/item/weapon/reagent_containers/food/drinks/shaker{
	pixel_x = -7
	},
/obj/item/weapon/reagent_containers/food/drinks/shaker{
	pixel_x = 11
	},
/obj/structure/hanging_lantern/dim{
	dir = 1
	},
/turf/simulated/floor/wood,
/area/ruin)
"Z" = (
/obj/structure/reagent_dispensers/brewerybeerkeg/contraband,
/obj/structure/table/woodentable,
/turf/simulated/floor/wood,
/area/ruin)

(1,1,1) = {"
L
L
d
L
L
b
Q
L
V
"}
(2,1,1) = {"
L
A
w
q
L
Y
w
v
l
"}
(3,1,1) = {"
L
n
w
u
L
e
w
F
l
"}
(4,1,1) = {"
L
E
w
w
d
t
w
v
l
"}
(5,1,1) = {"
L
w
w
U
L
b
Q
L
V
"}
(6,1,1) = {"
L
Z
Z
Z
L
a
a
a
a
"}
(7,1,1) = {"
L
L
L
L
L
a
a
a
a
"}
