//MAP CONVERTED BY dmm2tgm.py THIS HEADER COMMENT PREVENTS RECONVERSION, DO NOT REMOVE
"a" = (
/turf/template_noop,
/area/template_noop)
"i" = (
/turf/unsimulated/floor/planetary/dirt,
/area/exposed_ruin)
"j" = (
/obj/machinery/space_heater/campfire{
	burntime = 5
	},
/obj/machinery/cooking/grill/spit,
/turf/unsimulated/floor/planetary/dirt,
/area/exposed_ruin)
"l" = (
/obj/item/weapon/spear/wooden,
/turf/unsimulated/floor/planetary/dirt,
/area/exposed_ruin)
"N" = (
/obj/effect/landmark/corpse,
/turf/template_noop,
/area/exposed_ruin)
"Y" = (
/obj/abstract/loot_spawner/food_or_drink{
	containers = list(/obj/item/weapon/storage/box,/obj/item/weapon/storage/box/large)
	},
/turf/unsimulated/floor/planetary/dirt,
/area/exposed_ruin)

(1,1,1) = {"
a
a
N
a
a
"}
(2,1,1) = {"
a
a
l
a
a
"}
(3,1,1) = {"
a
i
j
i
a
"}
(4,1,1) = {"
a
a
Y
a
a
"}
(5,1,1) = {"
a
a
a
a
a
"}
