//MAP CONVERTED BY dmm2tgm.py THIS HEADER COMMENT PREVENTS RECONVERSION, DO NOT REMOVE
"a" = (
/turf/template_noop,
/area/template_noop)
"k" = (
/obj/structure/shuttle/engine/propulsion/right,
/obj/structure/shuttle/diag_wall/smooth{
	dir = 4
	},
/turf/unsimulated/floor/planetary/dirt,
/area/exposed_ruin)
"n" = (
/turf/unsimulated/floor/planetary/dirt,
/area/exposed_ruin)
"q" = (
/obj/structure/window/reinforced{
	dir = 8
	},
/obj/structure/grille/broken,
/obj/structure/bed/chair/shuttle{
	dir = 4
	},
/obj/abstract/loot_spawner/food_or_drink,
/turf/simulated/floor/shuttle/plating,
/area/exposed_ruin)
"s" = (
/obj/structure/shuttle/engine/propulsion/left,
/obj/structure/shuttle/diag_wall/smooth,
/turf/unsimulated/floor/planetary/dirt,
/area/exposed_ruin)
"v" = (
/turf/simulated/floor/shuttle,
/area/exposed_ruin)
"A" = (
/obj/effect/landmark/corpse/assistant/robust,
/obj/effect/decal/cleanable/blood/gibs/up{
	color = "#772222"
	},
/turf/template_noop,
/area/template_noop)
"C" = (
/obj/structure/shuttle/diag_wall/smooth{
	dir = 8
	},
/turf/unsimulated/floor/planetary/dirt,
/area/exposed_ruin)
"F" = (
/obj/machinery/light/small/broken{
	dir = 8
	},
/obj/structure/bed/chair/shuttle{
	dir = 8
	},
/obj/abstract/loot_spawner/medical,
/turf/simulated/floor/shuttle,
/area/exposed_ruin)
"H" = (
/turf/simulated/wall/shuttle,
/area/exposed_ruin)
"P" = (
/obj/structure/shuttle/diag_wall/smooth{
	dir = 1
	},
/turf/unsimulated/floor/planetary/dirt,
/area/exposed_ruin)
"U" = (
/obj/effect/decal/cleanable/blood/gibs/up{
	color = "#772222"
	},
/turf/unsimulated/floor/planetary/dirt,
/area/exposed_ruin)
"W" = (
/obj/abstract/loot_spawner/trash/on_ground,
/turf/unsimulated/floor/planetary/dirt,
/area/exposed_ruin)
"Y" = (
/obj/machinery/door/unpowered/shuttle,
/turf/simulated/floor/shuttle,
/area/exposed_ruin)

(1,1,1) = {"
a
a
a
a
a
a
a
a
a
a
a
"}
(2,1,1) = {"
a
a
a
C
H
H
s
n
n
a
a
"}
(3,1,1) = {"
a
A
U
q
v
F
Y
n
W
n
a
"}
(4,1,1) = {"
a
a
a
P
H
H
k
n
n
a
a
"}
(5,1,1) = {"
a
a
a
a
a
a
a
a
a
a
a
"}
