//MAP CONVERTED BY dmm2tgm.py THIS HEADER COMMENT PREVENTS RECONVERSION, DO NOT REMOVE
"a" = (
/turf/simulated/wall/shuttle,
/area/derelict/ship)
"b" = (
/turf/simulated/floor{
	icon_state = "white"
	},
/area/derelict/ship)
"c" = (
/obj/machinery/computer/crew,
/turf/simulated/floor/engine,
/area/derelict/ship)
"g" = (
/obj/structure/table,
/obj/item/weapon/storage/firstaid/toxin,
/turf/simulated/floor{
	icon_state = "white"
	},
/area/derelict/ship)
"j" = (
/obj/structure/window/reinforced{
	dir = 4
	},
/turf/space,
/area/derelict/ship)
"k" = (
/obj/structure/table,
/obj/item/weapon/storage/firstaid/adv,
/turf/simulated/floor/engine,
/area/derelict/ship)
"l" = (
/obj/structure/window/reinforced{
	dir = 4
	},
/obj/structure/window/reinforced{
	dir = 1
	},
/obj/structure/window/reinforced{
	dir = 8
	},
/turf/space,
/area/derelict/ship)
"m" = (
/obj/structure/window/reinforced,
/obj/structure/window/reinforced{
	dir = 4
	},
/turf/simulated/floor{
	icon_state = "white"
	},
/area/derelict/ship)
"n" = (
/obj/structure/window/reinforced{
	dir = 4
	},
/turf/simulated/floor{
	icon_state = "white"
	},
/area/derelict/ship)
"o" = (
/obj/structure/window/reinforced{
	dir = 1
	},
/obj/structure/window/reinforced{
	dir = 8
	},
/obj/structure/table,
/obj/item/weapon/storage/firstaid/fire,
/turf/simulated/floor{
	icon_state = "white"
	},
/area/derelict/ship)
"p" = (
/obj/structure/grille/window_spawner/reinforced/full,
/turf/simulated/floor/engine,
/area/derelict/ship)
"s" = (
/obj/structure/shuttle/diag_wall/smooth{
	dir = 1
	},
/turf/space,
/area/derelict/ship)
"t" = (
/obj/structure/shuttle/diag_wall/smooth{
	dir = 8
	},
/turf/space,
/area/derelict/ship)
"u" = (
/turf/space,
/area)
"v" = (
/obj/structure/shuttle/engine/heater{
	dir = 4
	},
/obj/structure/window/reinforced{
	dir = 8
	},
/turf/simulated/floor{
	icon_state = "white"
	},
/area/derelict/ship)
"w" = (
/obj/structure/shuttle/diag_wall/smooth,
/turf/space,
/area/derelict/ship)
"y" = (
/obj/structure/window/reinforced{
	dir = 4
	},
/obj/machinery/computer/med_data,
/turf/simulated/floor{
	icon_state = "white"
	},
/area/derelict/ship)
"z" = (
/obj/structure/window/reinforced{
	dir = 8
	},
/obj/structure/window/reinforced{
	dir = 1
	},
/turf/space,
/area/derelict/ship)
"A" = (
/obj/structure/table,
/turf/simulated/floor/engine,
/area/derelict/ship)
"C" = (
/obj/machinery/door/airlock/glass,
/turf/simulated/floor{
	icon_state = "white"
	},
/area/derelict/ship)
"D" = (
/turf/simulated/floor/engine,
/area/derelict/ship)
"E" = (
/obj/structure/window/reinforced{
	dir = 8
	},
/obj/machinery/sleeper,
/turf/simulated/floor{
	icon_state = "white"
	},
/area/derelict/ship)
"F" = (
/obj/structure/shuttle/engine/propulsion{
	dir = 4
	},
/turf/simulated/floor{
	icon_state = "white"
	},
/area/derelict/ship)
"H" = (
/obj/structure/window/reinforced{
	dir = 4
	},
/obj/structure/window/reinforced,
/obj/structure/window/reinforced{
	dir = 8
	},
/turf/space,
/area/derelict/ship)
"I" = (
/obj/structure/window/reinforced,
/obj/structure/window/reinforced{
	dir = 8
	},
/obj/structure/table,
/obj/item/weapon/storage/firstaid/o2,
/turf/simulated/floor{
	icon_state = "white"
	},
/area/derelict/ship)
"J" = (
/obj/structure/table,
/obj/item/weapon/storage/firstaid/regular{
	pixel_x = 2;
	pixel_y = 6
	},
/turf/simulated/floor{
	icon_state = "white"
	},
/area/derelict/ship)
"K" = (
/obj/structure/window/reinforced{
	dir = 8
	},
/obj/structure/window/reinforced,
/turf/space,
/area/derelict/ship)
"L" = (
/obj/structure/window/reinforced{
	dir = 8
	},
/obj/structure/table,
/obj/item/weapon/autopsy_scanner,
/turf/simulated/floor{
	icon_state = "white"
	},
/area/derelict/ship)
"M" = (
/obj/structure/window/reinforced{
	dir = 1
	},
/turf/simulated/floor{
	icon_state = "white"
	},
/area/derelict/ship)
"O" = (
/obj/structure/window/reinforced{
	dir = 8
	},
/obj/structure/table,
/obj/item/weapon/switchtool/surgery,
/turf/simulated/floor{
	icon_state = "white"
	},
/area/derelict/ship)
"P" = (
/obj/structure/window/reinforced{
	dir = 8
	},
/turf/space,
/area/derelict/ship)
"Q" = (
/obj/structure/window/reinforced{
	dir = 8
	},
/obj/structure/table,
/obj/item/tool/cautery,
/turf/simulated/floor{
	icon_state = "white"
	},
/area/derelict/ship)
"T" = (
/obj/machinery/door/airlock/multi_tile/glass{
	id_tag = "salvage_external"
	},
/turf/simulated/floor/engine,
/area/derelict/ship)
"U" = (
/obj/machinery/door/airlock/hatch,
/turf/simulated/floor{
	icon_state = "white"
	},
/area/derelict/ship)
"V" = (
/obj/structure/shuttle/diag_wall/smooth{
	dir = 4
	},
/turf/space,
/area/derelict/ship)
"W" = (
/obj/structure/window/reinforced,
/turf/simulated/floor{
	icon_state = "white"
	},
/area/derelict/ship)
"Y" = (
/obj/structure/window/reinforced{
	dir = 1
	},
/obj/structure/window/reinforced{
	dir = 4
	},
/turf/simulated/floor{
	icon_state = "white"
	},
/area/derelict/ship)
"Z" = (
/obj/machinery/optable,
/turf/simulated/floor{
	icon_state = "white"
	},
/area/derelict/ship)

(1,1,1) = {"
u
u
u
t
p
p
p
p
p
w
u
u
u
"}
(2,1,1) = {"
u
u
u
a
A
c
D
D
k
a
u
u
u
"}
(3,1,1) = {"
u
u
t
a
A
D
D
D
A
a
w
u
u
"}
(4,1,1) = {"
u
u
a
g
a
a
U
a
a
J
a
u
u
"}
(5,1,1) = {"
u
u
a
b
W
b
b
b
M
b
a
u
u
"}
(6,1,1) = {"
u
u
a
b
W
b
b
b
M
b
a
u
u
"}
(7,1,1) = {"
u
u
a
b
b
b
b
b
b
b
a
u
u
"}
(8,1,1) = {"
u
u
a
E
I
b
b
b
o
E
a
u
u
"}
(9,1,1) = {"
u
t
a
b
W
b
b
b
M
b
a
w
u
"}
(10,1,1) = {"
t
a
a
n
n
b
b
b
n
n
a
a
w
"}
(11,1,1) = {"
T
D
T
b
b
b
b
b
b
b
T
D
T
"}
(12,1,1) = {"
D
D
D
b
b
n
n
n
b
b
D
D
D
"}
(13,1,1) = {"
s
a
a
b
m
z
P
K
Y
b
a
a
V
"}
(14,1,1) = {"
u
a
b
W
l
j
j
j
H
M
b
a
u
"}
(15,1,1) = {"
u
a
b
b
a
L
Q
O
a
b
b
a
u
"}
(16,1,1) = {"
u
a
b
b
a
b
b
b
a
b
b
a
u
"}
(17,1,1) = {"
u
a
b
b
C
b
Z
b
C
b
b
a
u
"}
(18,1,1) = {"
u
a
b
b
a
b
b
b
a
b
b
a
u
"}
(19,1,1) = {"
u
a
n
n
a
a
a
a
a
n
y
a
u
"}
(20,1,1) = {"
u
a
v
v
w
u
u
u
t
v
v
a
u
"}
(21,1,1) = {"
u
s
F
F
V
u
u
u
s
F
F
V
u
"}
