//MAP CONVERTED BY dmm2tgm.py THIS HEADER COMMENT PREVENTS RECONVERSION, DO NOT REMOVE
"a" = (
/turf/template_noop,
/area/template_noop)
"b" = (
/obj/structure/flora/tree/pine,
/obj/abstract/loot_spawner/combat,
/turf/unsimulated/floor/snow,
/area/exposed_ruin)
"g" = (
/turf/unsimulated/floor/snow,
/area/exposed_ruin)
"q" = (
/mob/living/simple_animal/hostile/asteroid/goliath/snow/great,
/turf/unsimulated/floor/snow,
/area/exposed_ruin)
"r" = (
/obj/structure/flora/tree/pine,
/obj/abstract/loot_spawner/medical,
/turf/unsimulated/floor/snow,
/area/exposed_ruin)
"z" = (
/obj/structure/flora/tree/pine,
/turf/unsimulated/floor/snow,
/area/exposed_ruin)

(1,1,1) = {"
a
a
a
a
a
a
a
a
a
a
a
a
a
a
a
"}
(2,1,1) = {"
a
a
a
a
g
g
z
g
a
a
a
a
a
a
a
"}
(3,1,1) = {"
a
a
g
g
g
g
g
g
g
g
g
g
g
a
a
"}
(4,1,1) = {"
a
a
g
g
g
g
g
g
g
g
g
b
g
a
a
"}
(5,1,1) = {"
a
a
r
g
g
g
g
g
g
g
g
g
g
a
a
"}
(6,1,1) = {"
a
a
g
g
g
g
g
g
g
g
g
g
g
a
a
"}
(7,1,1) = {"
a
a
g
g
g
g
g
g
g
g
g
g
g
g
a
"}
(8,1,1) = {"
a
a
g
g
g
g
g
q
g
g
g
g
g
z
a
"}
(9,1,1) = {"
a
a
g
z
g
g
g
g
g
g
g
g
g
g
a
"}
(10,1,1) = {"
a
a
g
g
g
g
g
g
g
g
g
g
g
a
a
"}
(11,1,1) = {"
a
a
a
g
g
g
g
g
g
g
g
g
a
a
a
"}
(12,1,1) = {"
a
a
a
g
g
g
g
g
g
g
z
g
a
a
a
"}
(13,1,1) = {"
a
a
a
g
g
z
g
g
g
g
g
g
a
a
a
"}
(14,1,1) = {"
a
a
a
a
a
a
a
a
a
a
a
a
a
a
a
"}
(15,1,1) = {"
a
a
a
a
a
a
a
a
a
a
a
a
a
a
a
"}
