//MAP CONVERTED BY dmm2tgm.py THIS HEADER COMMENT PREVENTS RECONVERSION, DO NOT REMOVE
"z" = (
/obj/structure/hanging_lantern{
	dir = 1
	},
/turf/unsimulated/floor/snow/asphalt,
/area/exposed_ruin)
"F" = (
/obj/structure/sign/parking,
/turf/simulated/wall/mineral/wood,
/area/ruin)
"J" = (
/obj/structure/fence,
/turf/template_noop,
/area/exposed_ruin)
"L" = (
/obj/effect/decal/warning_stripes{
	icon_state = "bot"
	},
/obj/structure/bed/chair/vehicle/snowmobile/universal{
	dir = 4
	},
/turf/unsimulated/floor/snow/asphalt,
/area/exposed_ruin)

(1,1,1) = {"
F
z
J
"}
(2,1,1) = {"
J
L
J
"}
(3,1,1) = {"
J
J
J
"}
