//MAP CONVERTED BY dmm2tgm.py THIS HEADER COMMENT PREVENTS RECONVERSION, DO NOT REMOVE
"a" = (
/turf/template_noop,
/area/exposed_ruin)
"j" = (
/turf/unsimulated/floor/snow/dirt,
/area/exposed_ruin)
"t" = (
/obj/structure/flora/rock,
/turf/unsimulated/floor/snow/dirt,
/area/exposed_ruin)
"x" = (
/obj/structure/flora/rock/pile,
/turf/unsimulated/floor/snow/dirt,
/area/exposed_ruin)
"E" = (
/obj/structure/flora/rock/pile,
/mob/living/simple_animal/hostile/retaliate/goat/wooly,
/turf/unsimulated/floor/snow/dirt,
/area/exposed_ruin)
"Q" = (
/mob/living/simple_animal/hostile/retaliate/goat/wooly,
/turf/unsimulated/floor/snow/dirt,
/area/exposed_ruin)

(1,1,1) = {"
a
a
j
a
j
a
"}
(2,1,1) = {"
a
t
j
Q
t
a
"}
(3,1,1) = {"
j
j
Q
j
E
j
"}
(4,1,1) = {"
t
Q
x
Q
j
j
"}
(5,1,1) = {"
a
Q
t
Q
j
a
"}
(6,1,1) = {"
a
j
a
j
a
a
"}
