//MAP CONVERTED BY dmm2tgm.py THIS HEADER COMMENT PREVENTS RECONVERSION, DO NOT REMOVE
"a" = (
/turf/template_noop,
/area/exposed_ruin)
"g" = (
/turf/template_noop,
/area/template_noop)
"h" = (
/turf/simulated/wall/mineral/wood/log,
/area/ruin)
"m" = (
/obj/structure/curtain/open/bed,
/turf/template_noop,
/area/ruin)
"o" = (
/obj/machinery/old_database,
/turf/template_noop,
/area/ruin)
"z" = (
/obj/effect/decal/cleanable/campfire,
/obj/machinery/cooking/grill/spit,
/obj/effect/decal/cleanable/dirt,
/turf/template_noop,
/area/exposed_ruin)
"B" = (
/obj/item/weapon/spear,
/obj/effect/decal/cleanable/blood/splatter,
/obj/effect/decal/cleanable/dirt,
/turf/template_noop,
/area/exposed_ruin)
"F" = (
/obj/effect/decal/cleanable/dirt,
/turf/template_noop,
/area/exposed_ruin)
"J" = (
/obj/machinery/telecomms/relay/planetary,
/turf/template_noop,
/area/ruin)
"Q" = (
/obj/machinery/portable_atmospherics/hydroponics/soil,
/obj/item/weapon/bedsheet,
/obj/effect/decal/cleanable/dirt,
/obj/effect/landmark/story,
/turf/template_noop,
/area/ruin)

(1,1,1) = {"
h
h
h
h
h
"}
(2,1,1) = {"
h
J
o
Q
h
"}
(3,1,1) = {"
h
m
m
m
h
"}
(4,1,1) = {"
g
B
F
a
g
"}
(5,1,1) = {"
g
a
z
a
g
"}
(6,1,1) = {"
g
a
a
F
g
"}
