//MAP CONVERTED BY dmm2tgm.py THIS HEADER COMMENT PREVENTS RECONVERSION, DO NOT REMOVE
"a" = (
/turf/template_noop,
/area/template_noop)
"b" = (
/turf/simulated/wall/r_wall,
/area/ruin)
"c" = (
/obj/item/device/flashlight/lamp,
/obj/item/weapon/paper_bin,
/obj/structure/table,
/turf/simulated/floor/engine/acoustic,
/area/ruin)
"d" = (
/obj/item/clothing/head/welding,
/turf/simulated/floor/engine/concrete,
/area/ruin)
"e" = (
/obj/item/weapon/storage/toolbox/mechanical,
/turf/simulated/floor/engine/concrete,
/area/ruin)
"f" = (
/turf/simulated/floor/engine/concrete,
/area/ruin)
"g" = (
/obj/structure/bed/chair/office/dark{
	dir = 8
	},
/obj/effect/landmark/story,
/turf/simulated/floor/engine/acoustic,
/area/ruin)
"h" = (
/obj/machinery/light{
	dir = 1
	},
/turf/simulated/floor/engine/concrete,
/area/ruin)
"i" = (
/obj/machinery/door/airlock/engineering,
/turf/simulated/floor/plating,
/area/ruin)
"j" = (
/turf/template_noop,
/area/exposed_ruin)
"k" = (
/obj/structure/closet/toolcloset,
/turf/simulated/floor/engine/concrete,
/area/ruin)
"l" = (
/turf/simulated/floor/engine/acoustic,
/area/ruin)
"m" = (
/obj/effect/decal/mecha_wreckage/durand,
/turf/simulated/floor/engine/acoustic,
/area/ruin)
"n" = (
/obj/structure/rack,
/obj/item/stack/sheet/metal/bigstack,
/obj/item/stack/sheet/glass/glass/bigstack,
/obj/item/stack/sheet/plasteel,
/turf/simulated/floor/engine/concrete,
/area/ruin)
"o" = (
/obj/machinery/old_database,
/turf/simulated/floor/engine/acoustic,
/area/ruin)
"p" = (
/obj/structure/closet/crate,
/obj/item/weapon/circuitboard/telecomms/relay,
/turf/simulated/floor/engine/acoustic,
/area/ruin)
"q" = (
/obj/machinery/light{
	dir = 4
	},
/turf/simulated/floor/engine/acoustic,
/area/ruin)
"r" = (
/obj/machinery/telecomms/relay/planetary,
/turf/simulated/floor/engine/acoustic,
/area/ruin)
"B" = (
/obj/effect/decal/mecha_wreckage/odysseus,
/turf/simulated/floor/engine/concrete,
/area/ruin)
"H" = (
/obj/item/stack/cable_coil,
/obj/item/device/multitool,
/turf/simulated/floor/engine/concrete,
/area/ruin)

(1,1,1) = {"
b
b
b
b
b
b
a
"}
(2,1,1) = {"
b
H
B
f
n
b
a
"}
(3,1,1) = {"
b
d
f
f
k
b
a
"}
(4,1,1) = {"
b
h
f
f
f
i
j
"}
(5,1,1) = {"
b
e
f
f
f
b
a
"}
(6,1,1) = {"
b
l
l
g
c
b
a
"}
(7,1,1) = {"
b
o
l
l
m
b
a
"}
(8,1,1) = {"
b
r
q
l
p
b
a
"}
(9,1,1) = {"
b
b
b
b
b
b
a
"}
